form	lemma
آب	أبى
آثار	أثر
آخر	آخر
آخرها	آخر
آخرون	آخر
آخرين	آخر
آداب	أدب
آدم	دم
آر	آر
آراء	رأي
آسف	أسف
آسفة	آسف
آسيا	سي
آسيوي	آسي
آفاق	أفق
آل	آل
آلاف	ألف
آلة	آلة
آليات	آلية
آلية	لية
آمال	مال
آمنة	آمن
آنذاك	آنذاك
آنسة	آنسة
آيات	آية
أ	أ
أأنت	أن
أئمة	إمام
أبا	أب
أبحاث	بحث
أبدا	بدا
أبداً	بد
أبدو	بدا
أبدى	أبدى
أبراج	برج
أبرز	أبرز
أبرزها	أبرز
أبطال	بطل
أبعاد	بعد
أبعد	بعد
أبقى	بقي
أبل	بل
أبلغ	بلغ
أبناء	ابن
أبو	أب
أبواب	بواب
أبى	أبى
أبي	ب
أبيض	أبيض
أبين	بين
أبيه	أب
أتت	أتى
أتحدث	حدث
أتذكر	ذكر
أترك	رك
أترى	رأى
أتريد	أراد
أتعرف	عرف
أتعلم	علم
أتعلمين	علم
أتفهم	فهم
أتكلم	كلم
أتمنى	مني
أتوقع	وقع
أتى	أتى
أتيت	أتى
أثارت	أثار
أثبت	ثبت
أثبتت	ثبت
أثر	أثر
أثرت	أثر
أثرية	أثري
أثق	وثق
أثناء	ثني
أجانب	جانب
أجد	جد
أجرى	جرى
أجريت	جرى
أجزاء	جزء
أجل	جلا
أجلك	جلا
أجله	جلا
أجلي	جلا
أجمع	جمع
أجمل	جملة
أجنبي	أجنبي
أجنبية	أجنبي
أجندة	أجندة
أجهزة	جهاز
أجواء	جو
أجور	أجر
أجيال	جيل
أحاول	حاول
أحب	حب
أحببت	أحب
أحبك	حب
أحتاج	احتاج
أحد	حد
أحدا	حد
أحداث	حدث
أحداً	حد
أحدث	حدث
أحدكم	حد
أحدهم	حد
أحدهما	حد
أحرار	حر
أحرز	حرز
أحرقه	حرق
أحزاب	حزب
أحسن	حسن
أحسنت	حسن
أحضر	حضر
أحضرت	حضر
أحكام	حكم
أحلام	حلم
أحلم	حلم
أحلى	حلى
أحمد	حمد
أحمدي	حمد
أحمر	أحمر
أحمق	أحمق
أحوال	حال
أحياء	حي
أحيانا	حي
أحياناً	حين
أخ	أخ
أخبار	خبر
أخبارك	خبر
أخبر	خبر
أخبرتك	خبر
أخبرتني	خبر
أخبرك	خبر
أخبرني	خبر
أخبريني	أخبر
أختي	أخت
أخذ	أخذ
أخذت	أخذ
أخرج	خرج
أخرى	آخر
أخري	خر
أخشى	خشي
أخضر	أخضر
أخطاء	خطأ
أخطر	خطر
أخفي	خفي
أخواني	خوان
أخوكم	أخ
أخوي	أخ
أخي	أخ
أخيرا	خير
أخيراً	خير
أخيه	أخ
أداة	أداة
أدب	دب
أدت	أدى
أدرك	در
أدري	در
أدلة	دليل
أدنى	دنى
أدوات	أداة
أدوية	دواء
أدى	ودى
أديب	أديب
أذكر	ذكر
أراد	أراد
أرادت	أراد
أراضي	أرض
أراضيها	أرض
أراك	رأى
أراه	رأى
أرباح	ربح
أربع	ربع
أربعة	أربع
أربعين	ربع
أرجو	رجا
أرجوك	رجي
أرد	رد
أردت	رد
أردني	رد
أردنية	أردني
أرسل	رسول
أرسلت	أرسل
أرشفة	رشفة
أرشيف	أرشيف
أرض	أرض
أرضه	أرض
أرضية	أرضي
أرغب	رغب
أرغم	رغم
أرقام	رقم
أركان	ركن
أرمينيا	أرميني
أرواح	روح
أروع	روع
أرى	رأى
أريحا	ريح
أريد	أراد
أريدك	أراد
أريده	أراد
أزمات	أزمة
أزمة	أزمة
أزياء	زي
أس	أس
أسألك	سأل
أسئلة	سؤال
أسابيع	أسبوع
أساس	أساس
أساسا	أساس
أساسي	أساس
أساسية	أساسي
أساليب	أسلوب
أسباب	سبب
أسبوع	أسبوع
أسبوعية	أسبوعي
أسبوعين	أسبوع
أستاذ	أستاذ
أستراليا	أسترالي
أستطع	استطاع
أستطيع	استطاع
أسد	أسد
أسر	سر
أسرار	سر
أسرة	أسرة
أسرته	أسرة
أسرع	سرع
أسرى	أسرى
أسس	أساس
أسطورة	أسطورة
أسطول	أسطول
أسعار	سعر
أسعد	سعد
أسفر	سفر
أسفرت	سفر
أسفل	أسفل
أسلحة	سلاح
أسلوب	أسلوب
أسماء	اسم
أسمائها	اسم
أسماك	سم
أسمر	سمر
أسنان	سنة
أسهل	سهل
أسهم	أس
أسوأ	سوأ
أسواق	سوق
أسود	أسد
أسير	سير
أشاد	شاد
أشار	أشار
أشارت	أشار
أشبه	شاب
أشجار	شجرة
أشخاص	شخص
أشد	شيد
أشرف	شرف
أشعة	أشعة
أشعر	شعر
أشكال	شكل
أشهد	شهد
أشهر	شهر
أشياء	شيء
أصاب	أصاب
أصابع	إصبع
أصبح	صبح
أصبحت	صبح
أصحاب	صاحب
أصحابها	صاحب
أصدر	صدر
أصدرت	صدر
أصدق	صدق
أصدقاء	صديق
أصعب	صعب
أصغر	صغر
أصل	صلى
أصلا	وصل
أصلاً	أصل
أصناف	صنف
أصوات	صوت
أصول	أصل
أصيب	أصاب
أضاف	أضاف
أضخم	ضخم
أضرار	ضرر
أضع	وضع
أضعاف	ضعف
أضف	أضاف
أضيفت	أضاف
أطباء	طبيب
أطراف	طرف
أطفال	طفل
أطلق	طلق
أطلقت	طلق
أطمح	طمح
أطول	طول
أظن	ظن
أظهر	ظهر
أظهرت	ظهر
أعاد	عاد
أعتقد	اعتقد
أعجب	أعجب
أعد	عد
أعداء	عدو
أعدك	عد
أعراض	عرض
أعرب	عربي
أعرف	عرف
أعرفه	عرف
أعضاء	عضو
أعطني	أعطى
أعطى	أعطى
أعظم	عظم
أعقاب	عقاب
أعلم	علم
أعلن	عال
أعلنت	أعلن
أعلى	على
أعمال	عمل
أعماله	عمل
أعمالها	عمل
أعمالهم	عمل
أعمدة	عمود
أعني	عن
أعوام	عام
أعود	عاد
أعيش	عاش
أغاني	أغنية
أغرب	غرب
أغلب	غلب
أغلبية	أغلبية
أغلق	غلق
أغلى	غلا
أغنية	غني
أفاد	أفاد
أفادت	أفاد
أفراد	فرد
أفراده	فرد
أفسدوا	أفسد
أفشلنا	فشل
أفضل	فضل
أفعل	فعل
أفعله	فعل
أفكار	فكرة
أفكر	فكر
أفلام	فيلم
أفهم	فهم
أقام	قام
أقامت	قام
أقبل	قبل
أقدام	قدم
أقدر	قدرة
أقدم	قدم
أقر	قرى
أقرب	قرب
أقسام	قسم
أقسم	قسم
أقصد	قصد
أقصى	أقصى
أقل	قال
أقمار	قمر
أقول	قال
أقوله	قال
أقوم	قام
أقوى	قوة
أقوي	قوى
أقيم	قيم
أقيمت	قيم
أكاديمي	أكاديمي
أكاديمية	أكاديمي
أكاديميون	أكاديمي
أكبر	أكبر
أكثر	أكثر
أكد	أكد
أكدت	أكد
أكره	كر
أكل	كل
أكمل	كمل
أكن	كان
أكون	كان
أكيد	كيد
ألا	ألا
ألبوم	ألبوم
ألعاب	لعبة
ألف	ألف
ألفا	ألف
ألق	لقي
ألقت	قت
ألقى	لقي
ألم	لم
ألماني	لم
ألمانيا	ألماني
ألمانية	ألماني
ألن	لان
ألوان	لون
أليس	ليس
أم	ما
أما	ما
أماك	ما
أماكن	ما
أمام	أمام
أمامك	أمام
أمامنا	أمام
أمامه	أمام
أمان	ما
أمانة	أمانة
أماني	ما
أمة	أمة
أمثال	مثل
أمجد	مجد
أمر	أمر
أمرا	أمر
أمراض	مرض
أمراً	أمر
أمره	أمر
أمري	أمر
أمريكي	أمريكي
أمريكية	أمريكي
أمس	ماس
أمسك	ماس
أمسية	أمسية
أمشي	مش
أمضى	مضى
أمطار	مطار
أمك	ما
أمل	مال
أملك	ملك
أمم	أمة
أممي	أمة
أممية	أممي
أمن	من
أمناء	أمين
أمني	من
أمنيا	أمنى
أمنية	أمني
أمنيتي	أمني
أمه	ما
أموال	مال
أمواله	مال
أموت	موت
أمور	أمر
أمي	أم
أمير	أمار
أميرة	أمير
أميركي	أميركي
أميركية	أميركي
أمين	مين
أن	أن
أنا	أن
أناس	ناس
أنباء	نبأ
أنت	أن
أنتم	أن
أنتما	أن
أنثى	أنثى
أنجب	أجاب
أنحاء	ناحية
أندية	نادي
أنسى	نسي
أنشطة	نشاط
أنصار	نصير
أنظار	نظر
أنظمة	نظام
أنفسنا	نفس
أنفسهم	نفس
أنقرة	نقرة
أنك	أن
أنكم	أن
أننا	أن
أننى	ونى
أنني	أن
أنه	أن
أنها	أن
أنهم	أن
أنهما	أن
أنهى	وهى
أنوار	نور
أنواع	نوع
أنور	نور
أنى	ونى
أني	وني
أهالي	هال
أهتم	اهتم
أهداف	هدف
أهدافها	هدف
أهرام	هرم
أهل	أهل
أهلا	أهل
أهلاً	أهل
أهله	أهل
أهلها	أهل
أهلي	أهل
أهلية	أهلي
أهم	هم
أهمها	هم
أهمية	أهمية
أو	أو
أوائل	أول
أواخر	آخر
أوارد	وارد
أوامر	أمر
أوبرا	وبر
أوبرن	وبر
أوبك	أوب
أوجد	أوجد
أوجه	وجه
أود	ود
أوراق	ورق
أوروبي	أوروبي
أوروبية	أوروبي
أوساط	وسط
أوسع	وسع
أوضاع	وضع
أوضح	وضح
أوقات	وقت
أوقف	وقف
أوقفت	وقف
أوكرانيا	أوكراني
أول	ولى
أولا	أول
أولاد	ولد
أولاً	أول
أولها	أول
أولوية	أولوية
أولى	ولى
أولي	ولى
أوليا	ولى
أون	ونى
أوه	أوهى
أي	أي
أيا	أي
أيام	يوم
أياً	أي
أية	أي
أيتها	تاه
أيدي	يد
أيضا	أيض
أيضاً	أيض
أيقونة	أيقونة
أيمكنك	مكن
أيمن	من
أين	ونى
أينما	نام
أيها	أي
إبادة	إبادة
إبان	إبان
إبداع	إبداع
إتاحة	إتاحة
إتش	وشى
إثارة	إثارة
إثبات	إثبات
إثنان	إثنان
إثيوبيا	إثيوبي
إجابة	إجابة
إجازة	إجازة
إجمالي	إجمالي
إحالة	إحالة
إحباط	إحباط
إحدى	أحد
إحساس	إحساس
إحصاء	إحصاء
إحصائيات	إحصائي
إخباري	إخباري
إخبارية	إخباري
إخراج	إخراج
إخوان	أخ
إدارة	إدارة
إدارته	إدارة
إدارية	إداري
إدانة	إدانة
إدخال	إدخال
إدراج	إدراج
إذ	إذ
إذا	إذا
إذاعة	إذاعة
إذن	إذن
إرادة	إرادة
إرسال	إرسال
إرهاب	إرهاب
إرهابي	إرهاب
إرهابيا	إرهابي
إرهابية	إرهابي
إرهابيي	إرهابي
إرهابيين	إرهابي
إزالة	إزالة
إسبانيا	إسباني
إسرائيلي	إسرائيلي
إسرائيلية	إسرائيلي
إسرائيليين	إسرائيلي
إسقاط	إسقاط
إسلام	إسلام
إسلامي	إسلامي
إسلاميات	إسلامي
إسلامية	إسلامي
إشارات	إشارة
إشارة	إشارة
إشراف	إشراف
إصابات	إصابة
إصابة	إصابة
إصابته	إصابة
إصدار	إصدار
إصدارات	إصدار
إصلاح	إصلاح
إصلاحات	إصلاح
إضافة	إضافة
إضافية	إضافي
إضراب	إضراب
إطار	إطار
إطلاق	إطلاق
إظهار	إظهار
إعادة	إعادة
إعجاب	إعجاب
إعداد	إعداد
إعدام	إعدام
إعصار	إعصار
إعلام	إعلام
إعلامي	إعلام
إعلامية	إعلامي
إعلان	إعلان
إعلانات	إعلان
إعلاني	إعلان
إعمار	إعمار
إغلاق	إغلاق
إقالة	إقالة
إقامة	إقامة
إقبال	إقبال
إقرار	إقرار
إقليم	إقليم
إقليمية	إقليمي
إقناع	إقناع
إلكتروني	إلكتروني
إلكترونية	إلكتروني
إله	إله
إلهي	إله
إلى	إلى
إلي	إلى
إليك	إلى
إليكم	إلى
إلينا	إلى
إليه	إلى
إليها	إلى
إماراتي	إمارة
إمارة	إمارة
إمدادات	إمداد
إمكانية	إمكانية
إنتاج	إنتاج
إنجاز	إنجاز
إنجازات	إنجاز
إندونيسيا	إندونيسي
إنذار	إنذار
إنزال	زال
إنسان	إنسان
إنسانية	إنساني
إنشاء	إنشاء
إنقاذ	إنقاذ
إنما	ما
إهانة	إهانة
إيبدو	بدا
إيجابي	إيجابي
إيجابية	إيجابي
إيجاد	جاد
إيرادات	إيراد
إيران	ران
إيراني	رأى
إيرانية	إيراني
إيرانيتان	إيراني
إيطاليا	إيطالي
إيقاف	إيقاف
إيلاف	لاف
إيمان	ما
إيناس	ناس
إيه	وهي
إيهاب	هاب
ائتلاف	ائتلاف
ابتسامات	ابتسامة
ابتسامة	ابتسامة
ابتعد	ابتعد
ابتكار	ابتكار
ابحث	بحث
ابن	ابن
ابنة	ابن
ابنته	ابن
ابنتي	ابن
ابنك	ابن
ابنه	ابن
ابنها	ابن
ابني	ابن
اتباع	اتباع
اتبع	اتبع
اتجاه	اتجاه
اتحاد	اتحاد
اتخاذ	اتخاذ
اتخذ	اتخذ
اتخذت	اتخذ
اتصال	اتصال
اتصالات	اتصال
اتصل	اتصل
اتصلت	اتصل
اتفاق	اتفاق
اتفاقيات	اتفاقية
اتفاقية	اتفاقية
اتفق	اتفق
اتفقنا	اتفق
اتهام	اتهام
اتهامات	اتهام
اتهامه	اتهام
اتهم	اتهم
اتهمت	اتهم
اثنين	اثنين
اجتماع	اجتماع
اجتماعا	اجتماع
اجتماعات	اجتماع
اجتماعه	اجتماع
اجتماعها	اجتماع
اجتماعهم	اجتماع
اجتماعي	اجتماع
اجتمع	اجتمع
اجعل	جعل
اجلس	جلس
اجهزه	جهز
احتجاج	احتجاج
احتجاجا	احتجاج
احتجاجات	احتجاج
احتجاجية	احتجاجي
احتجاز	احتجاز
احتراف	احتراف
احترافي	احترافي
احترافية	احترافي
احترافيه	احترافي
احترام	احترام
احترامي	احترام
احتفال	احتفال
احتفالا	احتفال
احتفالات	احتفال
احتفالية	احتفالية
احتفل	احتفل
احتفلت	احتفل
احتلال	احتلال
احتمال	احتمال
احتمالات	احتمال
احتياطي	احتياطي
احتياطية	احتياطي
احذف	حذف
احصل	حصل
احفظ	حفظ
اختار	اختار
اختارت	اختار
اختبار	اختبار
اختبارات	اختبار
اختتام	اختتام
اختتم	اختتم
اختتمت	اختتم
اختر	اختار
اختراع	اختراع
اختراق	اختراق
اخترت	اختار
اختصار	اختصار
اختصارات	اختصار
اختطاف	اختطاف
اختفت	اختفى
اختفى	اختفى
اختلاف	اختلاف
اختيار	اختيار
اختيارك	اختيار
ادخل	دخل
ادفع	دفع
اذهب	ذهب
اذهبي	ذهب
اربد	اربد
ارتباط	ارتباط
ارتفاع	ارتفاع
ارتفاعا	ارتفاع
ارتفع	ارتفع
ارتفعت	ارتفع
ارتكاب	ارتكاب
ارجع	رجع
ارجوا	رجي
ارجوكم	رجي
ارحم	رحم
ارشفه	رشف
ارفع	رفع
ازدياد	ازدياد
ازرق	ازرق
اسأل	سأل
استئناف	استئناف
استبدال	استبدال
استبعاد	استبعاد
استثمار	استثمار
استثمارات	استثمار
استثناء	استثناء
استثنائية	استثنائي
استجابة	استجابة
استحوذ	استحوذ
استخدام	استخدام
استخدامه	استخدام
استخدامها	استخدام
استخدم	استخدم
استخدمت	استخدم
استخراج	استخراج
استدعاء	استدعاء
استراتيجية	استراتيجي
استرجاع	استرجاع
استشهاد	استشهاد
استضافة	استضافة
استضافه	استضاف
استطاع	استطاع
استطاعت	استطاع
استطعت	استطاع
استطلاع	استطلاع
استطلاعات	استطلاع
استعاد	استعاد
استعادة	استعادة
استعادت	استعاد
استعداد	استعداد
استعدادا	استعداد
استعدادات	استعداد
استعراض	استعراض
استعمال	استعمال
استغرقت	استغرق
استغفر	استغفر
استغلال	استغلال
استفتاء	استفتاء
استفسار	استفسار
استفسارات	استفسار
استقالة	استقالة
استقالته	استقالة
استقبال	استقبال
استقباله	استقبال
استقبل	استقبل
استقرار	استقرار
استقلال	استقلال
استكمال	استكمال
استلام	استلام
استمارة	استمارة
استمر	استمر
استمرار	استمرار
استمرت	استمر
استمع	استمع
استهداف	استهداف
استهدافهم	استهداف
استهدف	استهدف
استهدفت	استهدف
استهلاك	استهل
استيراد	استيراد
اسم	اسم
اسمح	سمح
اسمع	سمع
اسمعي	سمع
اسمك	اسم
اسمه	اسم
اسمها	اسم
اسمي	اسم
اشتباكات	اشتباك
اشتراك	اشتراك
اشتراكات	اشتراك
اشترك	اشترى
اشتركي	اشترك
اشتري	اشترى
اشتريت	اشترى
اشتغل	اشتغل
اشكرك	شكر
اصطدمت	اصطدم
اصطناعية	اصطناعي
اضطر	اضطر
اضطراب	اضطراب
اضطرابات	اضطراب
اضغط	ضغط
اطلب	طلب
اطلع	اطلع
اعتبار	اعتبار
اعتبارا	اعتبار
اعتبر	اعتبر
اعتبرت	اعتبر
اعتداء	اعتداء
اعتذار	اعتذار
اعتذر	اعتذر
اعتراض	اعتراض
اعتراف	اعتراف
اعترف	اعترف
اعتصام	اعتصام
اعتقال	اعتقال
اعتقالات	اعتقال
اعتقدت	اعتقد
اعتقلت	اعتقل
اعتماد	اعتماد
اعتماده	اعتماد
اعتمد	اعتمد
اعدل	عدل
اعرض	عرض
اعمل	عمل
اغتيال	اغتيال
افتتاح	افتتاح
افتتح	افتتح
افتح	فتح
افتراضي	افتراضي
اقتباس	اقتباس
اقتحام	اقتحام
اقتراب	اقتراب
اقتراح	اقتراح
اقترب	اقترب
اقترح	اقترح
اقتصاد	اقتصاد
اقتصادي	اقتصاد
اقتصاديا	اقتصادي
اقتصادية	اقتصادي
اقتصاديون	اقتصادي
اقرأ	قرأ
اكتئاب	اكتئاب
اكتب	كتب
اكتشاف	اكتشاف
اكتشف	اكتشف
اكتشفت	اكتشف
اكتمال	اكتمال
الآباء	أب
الآثار	أثر
الآخر	آخر
الآخرة	آخرة
الآخرون	آخر
الآخرين	آخر
الآداب	أدب
الآراء	رأي
الآسيوي	آسي
الآسيوية	آسيوي
الآلاف	ألف
الآلي	آل
الآلية	آلي
الآمنة	آمن
الآن	آن
الآنسة	آنسة
الآونة	أوان
الآية	آية
الأب	أب
الأبحاث	بحث
الأبد	أبد
الأبطال	بطل
الأبعاد	بعد
الأبناء	ابن
الأبنية	بناء
الأبواب	باب
الأبيض	أبيض
الأتراك	تركي
الأثر	أثر
الأثرية	أثري
الأثناء	ثني
الأجانب	أجنبي
الأجر	أجر
الأجزاء	جزء
الأجسام	جسم
الأجنبي	أجنبي
الأجنبية	أجنبي
الأجهزة	جهاز
الأجواء	جو
الأجور	أجر
الأجيال	جيل
الأحاديث	حديث
الأحد	أحد
الأحداث	حدث
الأحدث	أحدث
الأحرار	حر
الأحزاب	حزب
الأحزان	حزن
الأحكام	حكم
الأحلام	حلم
الأحمد	أحمد
الأحمر	أحمر
الأحمق	أحمق
الأحوال	حال
الأحياء	حي
الأحيان	حين
الأخ	أخ
الأخبار	خبر
الأخرى	آخر
الأخضر	أخضر
الأخطاء	خطأ
الأخلاق	خلق
الأخوة	أخوة
الأخير	أخير
الأخيرة	أخير
الأدب	أدب
الأدبية	أدبي
الأدلة	دليل
الأدنى	أدنى
الأدوات	أداة
الأدوار	دور
الأدوية	دواء
الأديان	دين
الأذن	أذن
الأراضي	أرض
الأرباح	ربح
الأربعين	أربعين
الأرجح	أرجح
الأرجنتيني	أرجنتيني
الأردني	أردني
الأردنية	أردني
الأردنيين	أردني
الأرز	أرز
الأرشيف	أرشيف
الأرصاد	أرصاد
الأرض	أرض
الأرضية	أرضي
الأرقام	رقم
الأركان	ركن
الأرمن	أرمن
الأرواح	روح
الأزرق	أزرق
الأزمات	أزمة
الأزمة	أزمة
الأزهر	أزهر
الأزياء	زي
الأسئلة	سؤال
الأسابيع	أسبوع
الأساس	أساس
الأساسي	أساس
الأساسية	أساسي
الأسباب	سبب
الأسبق	أسبق
الأسبوع	أسبوع
الأستاذ	أستاذ
الأسترالي	أسترالي
الأسد	أسد
الأسر	أسرة
الأسرة	أسرة
الأسرى	أسير
الأسعار	سعر
الأسف	أسف
الأسلحة	سلاح
الأسلوب	أسلوب
الأسماء	اسم
الأسماك	أسمى
الأسنان	سنة
الأسهم	أس
الأسواق	سوق
الأسود	أسد
الأسير	أسير
الأشجار	شجرة
الأشخاص	شخص
الأشعة	أشعة
الأشغال	أشغال
الأشكال	شكل
الأشهر	شهر
الأشياء	شيء
الأصحاب	صاحب
الأصدقاء	صديق
الأصل	أصل
الأصلي	أصل
الأصلية	أصلي
الأصوات	صوت
الأصول	أصل
الأضرار	ضرر
الأطباء	طبيب
الأطراف	طرف
الأطعمة	طعام
الأطفال	طفل
الأطلسي	أطلس
الأظافر	ظفر
الأعراض	عرض
الأعشاب	عشب
الأعضاء	عضو
الأعلى	أعلى
الأعمال	عمل
الأعمدة	عمود
الأعوام	عام
الأعيان	أعيان
الأغاني	أغنية
الأغذية	غذاء
الأغلبية	أغلبية
الأغنية	أغنية
الأغوار	غور
الأفراد	فرد
الأفضل	أفضل
الأفعال	فعل
الأفغانية	أفغاني
الأفق	أفق
الأفكار	فكرة
الأفلام	فيلم
الأقدم	أقدم
الأقسام	قسم
الأقصر	أقصر
الأقصى	أقصى
الأقل	أقل
الأقوى	أقوى
الأكاديمية	أكاديمي
الأكبر	أكبر
الأكثر	أكثر
الأكراد	كردي
الأكل	أكل
الألبوم	ألبوم
الألعاب	لعبة
الألف	ألف
الألم	ألم
الألمان	ألم
الألماني	ألماني
الألمانية	ألماني
الألوان	لون
الأم	أم
الأماكن	مكان
الأمان	أمان
الأمانة	أمانة
الأمة	أمة
الأمثل	أمثل
الأمد	أمد
الأمر	أمر
الأمراض	مرض
الأمريكي	أمريكي
الأمريكية	أمريكي
الأمريكيين	أمريكي
الأمس	أمس
الأمطار	مطر
الأمل	أمل
الأمم	أمة
الأممي	أمة
الأممية	أممي
الأمن	أمن
الأمني	أمن
الأمنية	أمني
الأموال	مال
الأمور	أمر
الأمية	أمي
الأمير	أمير
الأميرة	أمير
الأميركي	أميركي
الأميركية	أميركي
الأميركيين	أميركي
الأمين	أمين
الأنباء	نبأ
الأنبار	نبر
الأنبياء	نبي
الأندية	نادي
الأنشطة	نشاط
الأنظار	نظر
الأنظمة	نظام
الأنفاق	نفق
الأنواع	نوع
الأهالي	أهالي
الأهداف	هدف
الأهرام	هرم
الأهل	أهل
الأهلي	أهل
الأهلية	أهلي
الأهم	أهم
الأهمية	أهمية
الأوائل	أول
الأوامر	أمر
الأوان	أوان
الأوبرا	أوبر
الأوراق	ورق
الأورام	ورم
الأوروبي	أوروبي
الأوروبية	أوروبي
الأوروبيين	أوروبي
الأوساط	وسط
الأوسط	أوسط
الأوضاع	وضع
الأوفر	أوفر
الأوقات	وقت
الأوقاف	أوقاف
الأوكراني	أوكراني
الأوكرانية	أوكراني
الأول	أول
الأولاد	ولد
الأولوية	أولوية
الأولى	أول
الأولي	أول
الأولية	أولي
الأوليمبية	أوليمبي
الأيام	يوم
الأيتام	يتيم
الأيمن	يمين
الإبادة	إبادة
الإبداع	إبداع
الإثارة	إثارة
الإثيوبي	إثيوبي
الإثيوبيين	إثيوبي
الإجابات	إجابة
الإجابة	إجابة
الإجباري	إجبار
الإجمالي	إجمالي
الإحساس	إحساس
الإحصاء	إحصاء
الإحصائيات	إحصائي
الإخبارية	إخباري
الإخوان	أخ
الإدارة	إدارة
الإداري	إداري
الإدارية	إداري
الإدمان	إدمان
الإذاعة	إذاعة
الإرادة	إرادة
الإرهاب	إرهاب
الإرهابي	إرهاب
الإرهابية	إرهابي
الإرهابيين	إرهابي
الإساءة	إساءة
الإسباني	إسباني
الإسبانية	إسباني
الإسرائيلي	إسرائيلي
الإسرائيلية	إسرائيلي
الإسرائيليين	إسرائيلي
الإسعاف	إسعاف
الإسكان	إسكان
الإسلام	إسلام
الإسلامي	إسلامي
الإسلامية	إسلامي
الإسلاميين	إسلامي
الإسماعيلي	إسماعيلي
الإسماعيلية	إسماعيلية
الإشارة	إشارة
الإشراف	إشراف
الإصابات	إصابة
الإصابة	إصابة
الإصدار	إصدار
الإصلاح	إصلاح
الإصلاحات	إصلاح
الإضراب	إضراب
الإطار	إطار
الإطلاق	إطلاق
الإعاقة	إعاقة
الإعجاب	إعجاب
الإعداد	إعداد
الإعدام	إعدام
الإعلام	إعلام
الإعلامي	إعلام
الإعلامية	إعلامي
الإعلان	إعلان
الإعلانات	إعلان
الإعلاني	إعلان
الإغاثة	إغاثة
الإفراج	إفراج
الإفطار	إفطار
الإقامة	إقامة
الإقليم	إقليم
الإقليمي	إقليم
الإقليمية	إقليمي
الإلكتروني	إلكتروني
الإلكترونية	إلكتروني
الإلكترونيه	إلكترون
الإله	إله
الإمارات	إمارة
الإماراتي	إمارة
الإماراتية	إماراتي
الإمام	إمام
الإمبراطور	إمبراطور
الإمبراطورية	إمبراطورية
الإنتاج	إنتاج
الإنجاز	إنجاز
الإنجازات	إنجاز
الإنجليزي	إنجليزي
الإنجليزية	إنجليزي
الإنذار	إنذار
الإنسان	إنسان
الإنساني	إنساني
الإنسانية	إنساني
الإنقاذ	إنقاذ
الإهمال	إهمال
الإيجابية	إيجابي
الإيراني	إيراني
الإيرانية	إيراني
الإيطالي	إيطالي
الإيطالية	إيطالي
الإيمان	إيمان
الائتلاف	ائتلاف
الابتدائية	ابتدائي
الابتسامات	ابتسامة
الابتعاد	ابتعاد
الابن	ابن
الاتجار	اتجار
الاتجاه	اتجاه
الاتجاهات	اتجاه
الاتحاد	اتحاد
الاتحادات	اتحاد
الاتحادية	اتحادي
الاتصال	اتصال
الاتصالات	اتصال
الاتفاق	اتفاق
الاتفاقيات	اتفاقية
الاتفاقية	اتفاقية
الاتهام	اتهام
الاتهامات	اتهام
الاثنين	اثنين
الاجتماع	اجتماع
الاجتماعات	اجتماع
الاجتماعي	اجتماع
الاحتجاج	احتجاج
الاحتجاجات	احتجاج
الاحتراف	احتراف
الاحترافي	احترافي
الاحترافية	احترافي
الاحترام	احترام
الاحتفاظ	احتفاظ
الاحتفال	احتفال
الاحتفالات	احتفال
الاحتلال	احتلال
الاحتياطي	احتياطي
الاختبار	اختبار
الاختبارات	اختبار
الاختراق	اختراق
الاختلاف	اختلاف
الاختيار	اختيار
الادعاء	ادعاء
الارتباط	ارتباط
الارتفاع	ارتفاع
الاستئناف	استئناف
الاستبداد	استبداد
الاستثمار	استثمار
الاستثمارات	استثمار
الاستثمارية	استثماري
الاستجابة	استجابة
الاستخباراتية	استخباراتي
الاستخدام	استخدام
الاستراتيجي	استراتيجي
الاستراتيجية	استراتيجي
الاستضافة	استضافة
الاستطلاع	استطلاع
الاستعارة	استعارة
الاستعانة	استعانة
الاستعداد	استعداد
الاستعدادات	استعداد
الاستعمار	استعمار
الاستفادة	استفادة
الاستفتاء	استفتاء
الاستفسارات	استفسار
الاستقالة	استقالة
الاستقرار	استقرار
الاستقلال	استقلال
الاستماع	استماع
الاستمرار	استمرار
الاستهلاك	استهلاك
الاستوائية	استوائي
الاستيطان	استيطان
الاسم	اسم
الاشتباكات	اشتباك
الاشتباه	اشتباه
الاشتراك	اشتراك
الاشتراكات	اشتراك
الاشتراكي	اشتراك
الاضطرابات	اضطراب
الاطلاع	اطلاع
الاعتبار	اعتبار
الاعتداء	اعتداء
الاعتداءات	اعتداء
الاعتراف	اعتراف
الاعتقادات	اعتقاد
الاعتقال	اعتقال
الاعتماد	اعتماد
الافتتاح	افتتاح
الافتتاحية	افتتاحية
الافتراضي	افتراضي
الاقتباس	اقتباس
الاقتراحات	اقتراح
الاقتراع	اقتراع
الاقتصاد	اقتصاد
الاقتصادي	اقتصاد
الاقتصادية	اقتصادي
الاكتئاب	اكتئاب
الالتزام	التزام
الامتحان	امتحان
الامتحانات	امتحان
الانتباه	انتباه
الانتخاب	انتخاب
الانتخابات	انتخاب
الانتخابي	انتخاب
الانتخابية	انتخابي
الانتشار	انتشار
الانتصار	انتصار
الانتصارات	انتصار
الانتظار	انتظار
الانتفاضة	انتفاضة
الانتقادات	انتقاد
الانتقال	انتقال
الانتقالية	انتقالي
الانتقام	انتقام
الانتماء	انتماء
الانتهاكات	انتهاك
الانخراط	انخراط
الانسحاب	انسحاب
الانضمام	انضمام
الانفتاح	انفتاح
الانفجار	انفجار
الانفصال	انفصال
الانقسام	انقسام
الانقلاب	انقلاب
الانهيار	انهيار
الاهتمام	اهتمام
الباب	باب
البابا	باب
الباحة	باحة
الباحث	باحث
الباحثون	باحث
الباحثين	باحث
البادية	بادي
البارحة	بارحة
البارد	بارد
الباردة	بارد
الباز	باز
الباشا	باش
الباطن	باطن
الباعة	بائع
الباقي	باقي
الباكستاني	باكستاني
الباكستانية	باكستاني
البالغ	بالغ
البالغة	بالغ
البت	بت
البترا	بتر
البث	بث
البحار	بحر
البحث	بحث
البحر	بحر
البحري	بحر
البحرية	بحري
البحرين	بحر
البحوث	بحث
البحيرة	بحيرة
البخاري	بخاري
البدء	بدء
البداية	بداية
البدر	بدر
البدري	بدر
البدنية	بدني
البدوي	بدوي
البديل	بديل
البر	بر
البرادعي	بردعة
البرازيلي	برازيلي
البرامج	برنامج
البرتغالي	برتغالي
البرتغاليين	برتغالي
البرج	برج
البرد	برد
البرغوثي	برغوث
البرق	برق
البرقيات	برقية
البركة	بركة
البرلمان	برلمان
البرلمانية	برلماني
البرمجة	برمجة
البرنامج	برنامج
البروتوكول	بروتوكول
البرى	برى
البري	بر
البرية	بري
البريد	بريد
البريدية	بريدي
البسيط	بسيط
البسيطة	بسيط
البشر	بشر
البشرة	بشرة
البشري	بشر
البشرية	بشرية
البشير	بشير
البصر	بصر
البصل	بصل
البضائع	بضاعة
البطاقات	بطاقة
البطاقة	بطاقة
البطالة	بطال
البطريرك	بطريرك
البطل	بطل
البطن	بطن
البطولات	بطولة
البطولة	بطولة
البعث	بعث
البعثة	بعثة
البعد	بعد
البعض	بعض
البعيد	بعيد
البغدادي	بغدادي
البقر	بقرة
البقرة	بقرة
البقعة	بقعة
البلاد	بلد
البلجيكي	بلجيكي
البلد	بلد
البلدان	بلد
البلدة	بلدة
البلديات	بلدية
البلدية	بلدي
البلدين	بلد
البن	بن
البنا	بن
البناء	بناء
البنات	ابن
البنت	بنت
البنزين	بنزين
البنك	بن
البنكية	بنكي
البنوك	بنك
البنية	بني
البوابة	بواب
البورصة	بورصة
البيئة	بيئة
البيئي	بيئي
البيئية	بيئي
البيان	بيان
البيانات	بيان
البيت	بيت
البيض	أبيض
البيضاء	أبيض
البيع	بيع
البيوت	بيت
التآمر	تآمر
التأثير	تأثير
التأكد	تأكد
التأكيد	تأكيد
التأمين	تأمين
التأهل	تأهل
التابع	تابع
التابعة	تابع
التابعه	تابع
التاريخ	تاريخ
التاريخي	تاريخ
التاريخية	تاريخي
التاسع	تاسع
التاسعة	تاسع
التالي	تالي
التالية	تالي
التام	تام
التبادل	تبادل
التبرعات	تبرع
التتويج	تتويج
التثبيت	تثبيت
التجار	تاجر
التجارب	تجربة
التجارة	تجارة
التجاري	تجاري
التجارية	تجاري
التجديد	تجديد
التجربة	تجربة
التجسس	تجسس
التجمع	تجمع
التجميل	تجميل
التجميلية	تجميلي
التجنيد	تجنيد
التجول	تجول
التحالف	تحالف
التحتية	تحتية
التحدث	تحدث
التحدي	تحدي
التحديات	تحدي
التحديث	تحديث
التحديد	تحديد
التحرر	تحرر
التحرش	تحرش
التحرك	تحرك
التحرير	تحرير
التحريض	تحريض
التحضير	تحضير
التحضيرات	تحضير
التحفظ	تحفظ
التحقق	تحقق
التحقيق	تحقيق
التحقيقات	تحقيق
التحكم	تحكم
التحكيم	تحكيم
التحليل	تحليل
التحمل	تحمل
التحميل	تحميل
التحول	تحول
التحويل	تحويل
التحية	تحية
التخابر	تخابر
التخصصات	تخصص
التخطيط	تخطيط
التخلص	تخلص
التخلي	تخلي
التداول	تداول
التدخل	تدخل
التدخين	تدخين
التدريب	تدريب
التدريبات	تدريب
التدريبي	تدريب
التدريبية	تدريبي
التدريس	تدريس
التذاكر	تذكرة
التراب	تراب
التراث	تراث
التراجع	تراجع
التربوي	تربوي
التربوية	تربوي
التربية	تربية
الترتيب	ترتيب
الترجمة	ترجمة
الترجي	ترجي
الترجيح	ترجيح
الترحيب	ترحيب
الترخيص	ترخيص
الترشح	ترشح
الترشيح	ترشيح
الترفيه	ترفيه
الترقية	ترقية
الترقيه	ترقي
التركي	تركي
التركيب	تركيب
التركية	تركي
التركيز	تركيز
الترويج	ترويج
التزام	التزام
التزلج	تزلج
التسامح	تسامح
التسجيل	تسجيل
التسلية	تسلية
التسليم	تسليم
التسمم	تسمم
التسوق	تسوق
التسوية	تسوية
التسويق	تسويق
التشاورية	تشاوري
التشريعات	تشريع
التشريعي	تشريع
التشريعية	تشريعي
التشغيل	تشغيل
التشكيل	تشكيل
التشكيلة	تشكيلة
التشكيلي	تشكيل
التشهير	تشهير
التصاميم	تصميم
التصدي	تصدي
التصرف	تصرف
التصريح	تصريح
التصريحات	تصريح
التصعيد	تصعيد
التصفح	تصفح
التصميم	تصميم
التصنيع	تصنيع
التصنيف	تصنيف
التصويت	تصويت
التصوير	تصوير
التضامن	تضامن
التضخم	تضخم
التضييق	تضييق
التطبيق	تطبيق
التطبيقات	تطبيق
التطبيقية	تطبيقي
التطرف	تطرف
التطور	تطور
التطورات	تطور
التطوير	تطوير
التطويري	تطوير
التظاهر	تظاهر
التعادل	تعادل
التعاقد	تعاقد
التعامل	تعامل
التعاون	تعاون
التعبير	تعبير
التعديل	تعديل
التعديلات	تعديل
التعذيب	تعذيب
التعرض	تعرض
التعرف	تعرف
التعريب	تعريب
التعريف	تعريف
التعصب	تعصب
التعلم	تعلم
التعليق	تعليق
التعليقات	تعليق
التعليم	تعليم
التعليمي	تعليمي
التعليمية	تعليمي
التعويض	تعويض
التغذية	تغذية
التغطية	تغطية
التغلب	تغلب
التغير	تغير
التغيرات	تغير
التغيير	تغيير
التغييرات	تغيير
التفاصيل	تفاصيل
التفاعل	تفاعل
التفاعلية	تفاعلي
التفاهم	تفاهم
التفاوض	تفاوض
التفتيش	تفتيش
التفجير	تفجير
التفسير	تفسير
التفعيل	تفعيل
التفكير	تفكير
التفوق	تفوق
التقارب	تقارب
التقارير	تقرير
التقاط	التقاط
التقاعد	تقاعد
التقدم	تقدم
التقدير	تقدير
التقديم	تقديم
التقرير	تقرير
التقسيم	تقسيم
التقليدي	تقليد
التقليدية	تقليدي
التقني	تقني
التقنيات	تقنية
التقنية	تقنية
التقى	التقى
التقييم	تقييم
التكاليف	تكلفة
التكلفة	تكلفة
التكنولوجيا	تكنولوجي
التكنولوجية	تكنولوجي
التل	تل
التلاعب	تلاعب
التلفاز	تلفاز
التلفزيون	تلفزيون
التلفزيونية	تلفزيوني
التلقائي	تلقائي
التلوث	تلوث
التليفزيون	تليفزيون
التمارين	تمرين
التمثيل	تمثيل
التمدد	تمدد
التمرد	تمرد
التمويل	تمويل
التموين	تموين
التميز	تميز
التمييز	تمييز
التنافس	تنافس
التنبيه	تنبيه
التنس	تنس
التنسيق	تنسيق
التنصيب	تنصيب
التنظيم	تنظيم
التنفس	تنفس
التنفيذ	تنفيذ
التنفيذي	تنفيذ
التنفيذية	تنفيذي
التنموية	تنموي
التنمية	تنمية
التهاب	التهاب
التهديد	تهديد
التهديدات	تهديد
التهم	تهمة
التواجد	تواجد
التوازن	توازن
التواصل	تواصل
التوافق	توافق
التواقيع	توقيع
التوالي	توالي
التوبة	توبة
التوتر	توتر
التوجه	توجه
التوجيه	توجيه
التوجيهي	توجيه
التوحيد	توحيد
التورط	تورط
التوزيع	توزيع
التوسع	توسع
التوصل	توصل
التوضيح	توضيح
التوظيف	توظيف
التوفيق	توفيق
التوقعات	توقع
التوقف	توقف
التوقيت	توقيت
التوقيع	توقيع
التوكيل	توكيل
التونسي	تونسي
التونسية	تونسي
التي	التي
التيار	تيار
التيارات	تيار
الثابت	ثابت
الثالث	ثالث
الثالثة	ثالث
الثالثه	ثالث
الثامن	ثامن
الثامنة	ثامن
الثانوي	ثانوي
الثانوية	ثانوي
الثاني	ثاني
الثانية	ثاني
الثرثار	ثرثار
الثروة	ثروة
الثغرات	ثغرة
الثقافات	ثقافة
الثقافة	ثقافة
الثقافي	ثقافي
الثقافية	ثقافي
الثقة	ثقة
الثقيل	ثقيل
الثقيلة	ثقيل
الثلاثي	ثلاثي
الثلاثية	ثلاثي
الثلاثين	ثلاثين
الثلج	ثلج
الثلجية	ثلجي
الثمن	ثمن
الثنائي	ثنائي
الثنائية	ثنائي
الثوار	ثائر
الثورات	ثورة
الثورة	ثورة
الثوري	ثور
الثورية	ثوري
الجائزة	جائزة
الجاد	جاد
الجاذبية	جاذبية
الجاري	جار
الجارية	جاري
الجاف	جاف
الجافا	جاف
الجالية	جالية
الجامع	جامع
الجامعات	جامعة
الجامعة	جامعة
الجامعه	جامع
الجامعي	جامع
الجامعية	جامعي
الجانب	جانب
الجانبية	جانبي
الجانبين	جانب
الجبال	جبل
الجبل	جبل
الجبهة	جبهة
الجثة	جثة
الجثث	جثة
الجحيم	جحيم
الجد	جد
الجدار	جدار
الجداول	جدول
الجدد	جديد
الجدران	جدار
الجدل	جدل
الجدول	جدول
الجديد	جديد
الجديدة	جديد
الجرائم	جريمة
الجراثيم	جرثوم
الجرح	جرح
الجرحى	جريح
الجروح	جرح
الجريح	جريح
الجريدة	جريدة
الجريمة	جريمة
الجزء	جزء
الجزائري	جزائري
الجزائرية	جزائري
الجزر	جزيرة
الجزري	جزيرة
الجزيرة	جزيرة
الجسد	جسد
الجسر	جسر
الجسم	جسم
الجغرافي	جغرافي
الجغرافيا	جغرافي
الجفر	جفر
الجلالة	جلالة
الجلد	جلد
الجلسة	جلسة
الجلوس	جلوس
الجليد	جليد
الجليل	جليل
الجمارك	جمرك
الجماعات	جماعة
الجماعة	جماعة
الجماعي	جماعي
الجماعية	جماعي
الجمال	جملة
الجمالي	جملة
الجماهير	جماهير
الجمعة	جمعة
الجمعه	جمع
الجمعيات	جمعية
الجمعية	جمعية
الجمل	جملة
الجملة	جملة
الجمهور	جمهور
الجمهوري	جمهوري
الجمهورية	جمهوري
الجميع	جميع
الجميل	جميل
الجميلة	جميل
الجن	جن
الجنائي	جنائي
الجنائية	جنائي
الجناح	جناح
الجنايات	جناية
الجنة	جنة
الجندي	جندي
الجنرال	جنرال
الجنس	جنس
الجنسي	جنس
الجنسية	جنسي
الجنه	جن
الجنوب	جنوب
الجنوبي	جنوب
الجنوبية	جنوبي
الجنود	جندي
الجنون	جنون
الجنين	جنين
الجنيه	جنيه
الجهات	جهة
الجهاد	جهاد
الجهاديين	جهادي
الجهاز	جهاز
الجهة	جهة
الجهد	جهد
الجهود	جهد
الجو	جو
الجوائز	جائزة
الجواب	جواب
الجواد	جواد
الجوار	جوار
الجوال	جوال
الجوانب	جانب
الجودة	جودة
الجوع	جوع
الجوف	جوف
الجولان	جولان
الجولة	جولة
الجوهري	جوهر
الجوي	جو
الجوية	جوي
الجيد	جيد
الجيدة	جيد
الجيران	جار
الجيش	جيش
الجيل	جيل
الجيوش	جيش
الحاج	حاج
الحاجة	حاجة
الحادث	حادث
الحادثة	حادثة
الحادي	حادي
الحادية	حادي
الحارة	حار
الحارثي	حارث
الحارس	حارس
الحاسب	حاسب
الحاسوب	حاسوب
الحاصل	حاصل
الحاضر	حاضر
الحافز	حافز
الحافلة	حافلة
الحاكم	حاكم
الحاكمة	حاكم
الحال	حال
الحالات	حالة
الحالة	حالة
الحالي	حال
الحالية	حالي
الحامل	حامل
الحاويات	حاوي
الحب	حب
الحبل	حبل
الحبوب	حب
الحبيب	حبيب
الحبيبة	حبيب
الحج	حج
الحجاب	حجاب
الحجاج	حاج
الحجة	حجة
الحجر	حجر
الحجري	حجر
الحجز	حجز
الحجم	حجم
الحد	حد
الحداثة	حداثة
الحدث	حدث
الحدود	حد
الحدودي	حد
الحدودية	حدودي
الحديث	حديث
الحديثة	حديث
الحديد	حديد
الحديدي	حديد
الحديدية	حديدي
الحديقة	حديقة
الحذر	حذر
الحذف	حذف
الحر	حر
الحرارة	حرارة
الحرارية	حراري
الحراك	حراك
الحرام	حرام
الحرب	حرب
الحربي	حرب
الحربية	حربي
الحرة	حر
الحرس	حارس
الحرص	حرص
الحرف	حرفة
الحركات	حركة
الحركة	حركة
الحرم	حرم
الحرمان	حرمان
الحروب	حرب
الحروف	حرفة
الحريات	حرية
الحرية	حرية
الحريري	حرير
الحريق	حريق
الحزب	حزب
الحزم	حزمة
الحزن	حزن
الحزين	حزين
الحساب	حساب
الحسابات	حساب
الحساسة	حساس
الحساسية	حساسية
الحسكة	حسكة
الحسم	حسم
الحسن	حسن
الحسيني	لحس
الحشد	حشد
الحشرات	حشرة
الحشيش	حشيش
الحصار	حصار
الحصان	حصان
الحصول	حصول
الحضارات	حضارة
الحضارة	حضارة
الحضاري	حضاري
الحضور	حضور
الحظ	حظ
الحظر	حظر
الحفاظ	حفاظ
الحفر	حفرة
الحفل	حفل
الحفلة	حفلة
الحق	حق
الحقائق	حقيقة
الحقد	حقد
الحقل	حقل
الحقوق	حق
الحقوقية	حقوقي
الحقول	حقل
الحقيبة	حقيبة
الحقيقة	حقيقة
الحقيقه	حقيق
الحقيقي	حقيقي
الحقيقية	حقيقي
الحكام	حكم
الحكم	حكم
الحكمة	حكمة
الحكومات	حكومة
الحكومة	حكومة
الحكومي	حكومي
الحكومية	حكومي
الحكيم	حكيم
الحل	حل
الحلال	حلال
الحلبي	حلب
الحلف	حلف
الحلقات	حلقة
الحلقة	حلقة
الحلم	حلم
الحلو	حلو
الحلول	حل
الحليب	حليب
الحليم	حليم
الحمام	حمام
الحماية	حماية
الحمة	حمة
الحمد	حمد
الحمراء	أحمر
الحمض	حمض
الحمل	حمل
الحملات	حملة
الحملة	حامل
الحميد	حميد
الحميدة	حميد
الحنان	حنان
الحنفي	حنفي
الحنين	حنين
الحواجز	حاجز
الحوادث	حادث
الحوار	حوار
الحي	حي
الحياة	حياة
الحياه	حي
الحية	حي
الحين	لحى
الحيوان	حيوان
الحيوانات	حيوان
الحيوية	حيوي
الخادم	خادم
الخارج	خارج
الخارجي	خارجي
الخارجية	خارجي
الخاص	خاص
الخاصة	خاص
الخاطئة	خاطئ
الخالق	خالق
الخام	خام
الخامس	خامس
الخامسة	خامس
الخبر	خبر
الخبراء	خبير
الخبرات	خبرة
الخبرة	خبرة
الخبره	خبر
الخبز	خبز
الخبير	خبير
الخدمات	خدمة
الخدمة	خدمة
الخدمه	خدم
الخرائط	خريطة
الخرج	خرج
الخرطوم	خرطوم
الخروج	خروج
الخريطة	خريطة
الخريف	خريف
الخسائر	خسارة
الخسارة	خسارة
الخشب	خشب
الخشبي	خشب
الخصم	خصم
الخصوص	خصوص
الخصوصية	خصوصية
الخضار	خضار
الخضراء	أخضر
الخط	خط
الخطأ	خطأ
الخطاب	خطاب
الخطب	خطبة
الخطة	خطة
الخطر	خطر
الخطط	خطة
الخطوات	خطوة
الخطوة	خطوة
الخطورة	خطورة
الخطوط	خط
الخطيب	خطيب
الخطيرة	خطير
الخفيفة	خفيف
الخلاف	خلاف
الخلافات	خلاف
الخلافة	خلافة
الخلايا	خلية
الخلف	خلف
الخلفي	خلف
الخلفية	خلفية
الخلق	خلق
الخلل	خلل
الخلية	خلية
الخليج	خليج
الخليجي	خليج
الخليجية	خليجي
الخليفة	خليفة
الخليل	خليل
الخليلي	خليل
الخمر	خمر
الخمس	خمس
الخمول	خمول
الخميس	خميس
الخنازير	خنزير
الخناق	خناق
الخوف	خوف
الخيار	خيار
الخيارات	خيار
الخياط	خياط
الخيال	خيال
الخير	خير
الخيرية	خيري
الخيمة	خيمة
الخيول	خيل
الدائرة	دائرة
الدائم	دائم
الدائمة	دائم
الداخل	داخل
الداخلي	داخل
الداخلية	داخلي
الدار	دار
الداعمة	داعم
الدافئ	دافئ
الدبلوماسي	دبلوماسي
الدبلوماسية	دبلوماسي
الدخان	دخان
الدخل	دخل
الدخول	دخول
الدراجات	دراجة
الدراسات	دراسة
الدراسة	دراسة
الدراسي	دراس
الدراسية	دراسي
الدرب	درب
الدرجة	درجة
الدردشة	دردشة
الدرس	درس
الدرع	درع
الدرك	در
الدروس	درس
الدستور	دستور
الدستوري	دستور
الدستورية	دستوري
الدسمة	دسم
الدعاء	دعاء
الدعاية	دعاية
الدعم	دعم
الدعوات	دعوة
الدعوة	دعوة
الدفاع	دفاع
الدفاعية	دفاعي
الدفع	دفع
الدفعة	دفعة
الدقائق	دقيقة
الدقة	دقة
الدقيق	دقيق
الدقيقة	دقيقة
الدكتور	دكتور
الدكتوراه	دكتور
الدكتورة	دكتورة
الدلالي	دلال
الدليل	دليل
الدم	دم
الدماء	دم
الدمار	دمار
الدماغ	دماغ
الدمام	دمام
الدمشقي	دمشقي
الدموع	دمعة
الدموية	دموي
الدنيا	دني
الدواء	دواء
الدوائر	دائرة
الدوار	دوار
الدوام	دوام
الدوحة	دوحة
الدور	دار
الدورات	دورة
الدورة	دورة
الدوري	دار
الدوريات	دورية
الدورية	دوري
الدول	دولة
الدولار	دولار
الدولارات	دولار
الدولة	دولة
الدولتين	دولة
الدوله	دولة
الدولي	دولة
الدولية	دولي
الدوليين	دولي
الديك	ديك
الديمقراطي	ديمقراطي
الديمقراطية	ديمقراطي
الديموقراطية	ديموقراطي
الدين	دين
الديني	دين
الدينية	ديني
الديوان	ديوان
الديون	دين
الذئب	ذئب
الذات	ذات
الذاتي	ذات
الذاتية	ذاتي
الذاكرة	ذاكرة
الذرية	ذري
الذكر	ذكر
الذكرى	ذكرى
الذكريات	ذكرى
الذكور	ذكر
الذكي	ذكي
الذكية	ذكي
الذنوب	ذنب
الذهاب	ذهاب
الذهب	ذهب
الذهبي	ذهب
الذهبية	ذهبي
الذوق	ذوق
الذي	ذو
الذين	الذي
الرأس	رأس
الرأسمالية	رأسمالية
الرأي	رأي
الرؤية	رؤية
الرئاسة	رئاسة
الرئاسي	رئاسي
الرئاسية	رئاسي
الرئة	رئة
الرئيس	رئيس
الرئيسة	رئيس
الرئيسي	رئيس
الرئيسية	رئيسي
الرئيسيه	رئيس
الرائد	رائد
الرائدة	رائد
الرائع	رائع
الرائعة	رائع
الرائعه	رائع
الرابط	رابط
الرابطة	رابطة
الرابع	رابع
الرابعة	رابع
الرابعه	رابع
الراتب	راتب
الراجحي	راجح
الراجل	راجل
الراحة	راحة
الراحل	راحل
الراشد	راشد
الراعي	راع
الراقي	راق
الرالي	رالي
الراهن	راهن
الراهنة	راهن
الرب	رب
الربح	ربح
الربط	ربط
الربع	ربع
الربيع	ربيع
الرجال	رجل
الرجل	رجل
الرجوع	رجوع
الرحلات	رحلة
الرحلة	رحلة
الرحم	رحم
الرحمة	رحمة
الرحمن	رحمن
الرحيل	رحيل
الرحيم	رحيم
الرد	رد
الردود	رد
الرسائل	رسالة
الرسالة	رسالة
الرسام	رسام
الرسم	رسم
الرسمي	رسم
الرسمية	رسمي
الرسميه	رسم
الرسول	رسول
الرسوم	رسم
الرشيد	رشيد
الرصاص	رصاصة
الرضا	رض
الرعاية	رعاية
الرعب	رعب
الرغبة	رغبة
الرغم	رغم
الرفض	رفض
الرفع	رفع
الرقابة	رقابة
الرقة	رقة
الرقص	رقص
الرقم	رقم
الرقمي	رقم
الرقمية	رقمي
الركاب	راكب
الركن	ركن
الرمادي	رماد
الرمال	رمال
الرمز	رمز
الرمزية	رمزي
الرمضاني	رمضاني
الرمضانية	رمضاني
الرموز	رمز
الرهائن	رهينة
الروائي	روائي
الروابط	رابط
الرواتب	راتب
الرواية	رواية
الروبوتات	روبوت
الروح	روح
الروس	روسي
الروسي	روسي
الروسية	روسي
الروعة	روعة
الروعه	روع
الروقي	روق
الرومانسية	رومانسي
الروماني	روماني
الرومانية	روماني
الري	ري
الرياح	ريح
الرياض	الرياض
الرياضة	رياضة
الرياضي	رياضي
الرياضيات	رياضي
الرياضية	رياضي
الرياضيين	رياضي
الريال	ريال
الريان	ريان
الريح	ريح
الريف	ريف
الزائد	زائد
الزائر	زائر
الزاهر	زاهر
الزاوية	زاوية
الزجاج	زجاج
الزر	زر
الزراعة	زراعة
الزراعي	زراعي
الزراعية	زراعي
الزرقاء	أزرق
الزعيم	زعيم
الزفاف	زفاف
الزكاة	زكاة
الزلزال	زلزال
الزمان	زمان
الزمن	زمن
الزمني	زمن
الزميل	زميل
الزهرة	زهرة
الزهور	زهرة
الزواج	زوج
الزوار	زائر
الزوج	زوج
الزوجة	زوج
الزوجية	زوجي
الزور	زور
الزيادة	زيادة
الزيارات	زيارة
الزيارة	زيارة
الزيت	زيت
الزيتون	زيتون
السؤال	سؤال
السائح	سائح
السائق	سائق
السائقين	سائق
السائل	سائل
السابع	سابع
السابعة	سابع
السابق	سابق
السابقة	سابق
السابقين	سابق
الساحة	ساحة
الساحر	ساحر
الساحل	ساحل
الساحلي	ساحل
الساحلية	ساحلي
السادة	سيد
السادس	سادس
السادسة	سادس
الساعات	ساعة
الساعة	ساعة
السامي	سامي
السامية	سامي
الساهر	ساهر
السباحة	سباح
السباق	سباق
السبب	سبب
السبت	سبت
السبع	سبع
السبيل	سبيل
الست	ست
الستار	ستار
السجائر	سيجارة
السجل	سجل
السجن	سجن
السجناء	سجين
السجون	سجن
السحاب	سحابة
السحب	سحب
السحر	سحر
السحرية	سحري
السخنة	سخن
السد	سد
السر	سر
السرطان	سرطان
السرعة	سرعة
السرقة	سرقة
السري	سر
السرية	سري
السرير	سرير
السريع	سريع
السريعة	سريع
السطح	سطح
السطر	سطر
السعادة	سعادة
السعدي	سعد
السعر	سعر
السعودي	سعودي
السعودية	سعودي
السعوديون	سعودي
السعوديين	سعودي
السعي	سعي
السعيد	سعيد
السفارات	سفارة
السفارة	سفارة
السفر	سفر
السفراء	سفير
السفلي	سفلي
السفن	سفينة
السفير	سفير
السفينة	سفينة
السقوط	سقوط
السكان	ساكن
السكاني	ساكن
السكانية	سكاني
السكة	سكة
السكر	سكر
السكري	سكر
السكن	سكن
السكنية	سكني
السلاح	سلاح
السلام	سلام
السلامة	سلامة
السلبي	سلبي
السلبية	سلبي
السلة	سلة
السلسلة	سلسلة
السلط	سلطة
السلطات	سلطة
السلطان	سلطان
السلطاني	سلطان
السلطة	سلطة
السلطنة	سلطنة
السلع	سلعة
السلفي	سلفي
السلفية	سلفي
السلم	سلم
السلمي	سلم
السلمية	سلمي
السلوك	سلوك
السليم	سليم
السماء	سماء
السماح	سماح
السمعة	سمعة
السمك	سم
السمكية	سمكي
السمنة	سمنة
السمو	سمو
السن	سن
السنة	سنة
السنه	سن
السنوات	سنة
السنوي	سنوي
السنوية	سنوي
السنية	سني
السنين	سنة
السهل	سهل
السهم	سهم
السواحل	ساحل
السود	أسود
السوداء	أسود
السوداني	سوداني
السودانية	سوداني
السوري	سوري
السورية	سوري
السوريون	سوري
السوريين	سوري
السوفيتي	سوفيتي
السوق	سوق
السويدي	سويدي
السويسري	سويسري
السي	سي
السيئة	سيئ
السياح	سياح
السياحة	سياح
السياحي	سياح
السياحية	سياحي
السيادة	سيادة
السيارات	سيارة
السيارة	سيارة
السياره	سيار
السياسات	سياسة
السياسة	سياسة
السياسي	سياسي
السياسية	سياسي
السياسيه	سياسي
السياسيين	سياسي
السياق	سياق
السيد	سيد
السيدات	سيد
السيدة	سيد
السير	سير
السيرة	سيرة
السيطرة	سيطرة
السيف	سيف
السيل	سيل
السيناريو	سيناريو
السينمائي	سينمائي
السينمائية	سينمائي
الشأن	شأن
الشؤون	شأن
الشئون	شأن
الشائعات	شائعة
الشاب	شاب
الشابة	شاب
الشاحنات	شاحنة
الشاحنة	شاحنة
الشارع	شارع
الشاشة	شاشة
الشاشه	شاش
الشاطئ	شاطئ
الشاعر	شاعر
الشافعي	شافع
الشاقة	شاق
الشامل	شامل
الشاملة	شامل
الشامي	شامي
الشباب	شاب
الشبابي	شاب
الشبابية	شبابي
الشباك	شبكة
الشبان	شاب
الشبكات	شبكة
الشبكة	شبكة
الشتاء	شتاء
الشتوية	شتوي
الشجاعة	شجاع
الشجرة	شجرة
الشجري	شجرة
الشحن	شحن
الشحي	شح
الشخص	شخص
الشخصي	شخص
الشخصيات	شخصية
الشخصية	شخصي
الشخصيه	شخص
الشديد	شديد
الشديدة	شديد
الشر	شر
الشراء	شراء
الشراب	شراب
الشراكة	شراكة
الشرب	شرب
الشرح	شرح
الشرخ	شرخ
الشرطة	شرطي
الشرطه	شرط
الشرطي	شرطي
الشرعي	شرعي
الشرعية	شرعي
الشرعيه	شرع
الشرف	شرف
الشرفاء	شريف
الشرق	شرق
الشرقي	شرق
الشرقية	شرقي
الشركات	شركة
الشركة	شركة
الشركه	شرك
الشروط	شرط
الشروق	شروق
الشريط	شريط
الشريعة	شريعة
الشريف	شريف
الشريفين	شريف
الشطرنج	شطرنج
الشعار	شعار
الشعارات	شعار
الشعاع	شعاع
الشعب	شعب
الشعبي	شعب
الشعبية	شعبي
الشعر	شعر
الشعراء	شاعر
الشعرية	شعري
الشعوب	شعب
الشعور	شعور
الشغب	شغب
الشغل	شغل
الشغور	شغور
الشفافية	شفافية
الشقق	شقة
الشقيقة	شقيق
الشقيقين	شقيق
الشك	شك
الشكر	شكر
الشكل	شكل
الشمال	شمال
الشمالي	شمال
الشمالية	شمالي
الشمس	شمس
الشمسية	شمسي
الشهادات	شهادة
الشهادة	شهادة
الشهداء	شهيد
الشهر	شهر
الشهرة	شهرة
الشهري	شهر
الشهرية	شهري
الشهود	شاهد
الشهور	شهر
الشهيد	شهيد
الشهير	شهير
الشهيرة	شهير
الشوارع	شارع
الشوط	شوط
الشوق	شوق
الشونة	شونة
الشيء	شيء
الشيخ	شيخ
الشيطان	شيطان
الشيعة	شيعي
الشيعي	شيعي
الشيعية	شيعي
الشيكات	شيك
الشيوخ	شيخ
الشيوعي	شيوعي
الصادر	صادر
الصادرة	صادر
الصادق	صادق
الصاروخ	صاروخ
الصالح	صالح
الصالحة	صالح
الصباح	صباح
الصباغ	صباغ
الصبح	صبح
الصبر	صبر
الصحابة	صحابي
الصحافة	صحافة
الصحافي	صحافي
الصحة	صحة
الصحراوي	صحراوي
الصحف	صحيفة
الصحفي	صحيفة
الصحفية	صحفي
الصحفيون	صحفي
الصحفيين	صحفي
الصحي	صحي
الصحية	صحي
الصحيح	صحيح
الصحيحة	صحيح
الصحيفة	صحيفة
الصدارة	صدارة
الصداقة	صداقة
الصدد	صدد
الصدر	صدر
الصدمة	صدمة
الصديق	صديق
الصراحة	صراحة
الصراع	صراع
الصراعات	صراع
الصربي	صربي
الصرف	صرف
الصريح	صريح
الصعب	صعب
الصعبة	صعب
الصعود	صعود
الصعيد	صعيد
الصغار	صغير
الصغر	صغر
الصغير	صغير
الصغيرة	صغير
الصف	صف
الصفحات	صفحة
الصفحة	صفحة
الصفحه	صفح
الصفر	أصفر
الصفراء	أصفر
الصفقة	صفقة
الصقيع	صقيع
الصلاة	صلاة
الصلاحية	صلاحية
الصلب	صلب
الصلة	صلة
الصليب	صليب
الصمت	صمت
الصمود	صمود
الصناعات	صناعة
الصناعة	صناعة
الصناعي	صانع
الصناعية	صناعي
الصندوق	صندوق
الصنع	صنع
الصهاينة	صهاينة
الصهيوني	صهيوني
الصهيونية	صهيوني
الصواب	صواب
الصواريخ	صاروخ
الصوت	صوت
الصوتي	صوت
الصوتية	صوتي
الصور	صورة
الصورة	صورة
الصوره	صورة
الصومالية	صومالي
الصيام	صيام
الصيانة	صيانة
الصيد	صيد
الصيف	صيف
الصيفي	صيف
الصيفية	صيفي
الصيني	صيني
الصينية	صيني
الضائع	ضائع
الضابط	ضابط
الضابطة	ضابط
الضاحية	ضاحية
الضارة	ضار
الضالع	ضالع
الضباب	ضباب
الضباط	ضابط
الضحايا	ضحية
الضحك	ضحك
الضحية	ضحية
الضخم	ضخم
الضخمة	ضخم
الضرائب	ضريبة
الضربات	ضربة
الضربة	ضربة
الضرر	ضرر
الضروري	ضروري
الضرورية	ضروري
الضريبة	ضريبة
الضعف	ضعف
الضغط	ضغط
الضغوط	ضغوط
الضفة	ضفة
الضمان	ضمان
الضيف	ضيف
الضيوف	ضيف
الطائرات	طائرة
الطائرة	طائرة
الطائف	طائف
الطائفة	طائفة
الطائفي	طائفي
الطائفية	طائفي
الطابع	طابع
الطابق	طابق
الطاقة	طاقة
الطاقم	طاقم
الطالب	طالب
الطاولة	طاولة
الطب	طب
الطبخ	طبخ
الطبعة	طبعة
الطبقات	طبقة
الطبقة	طبقة
الطبي	طب
الطبيب	طبيب
الطبية	طبي
الطبيعة	طبيعة
الطبيعي	طبيعي
الطبيعية	طبيعي
الطراز	طراز
الطرح	طرح
الطرف	طرف
الطرفين	طرف
الطرق	طريقة
الطريق	طريق
الطريقة	طريقة
الطريقه	طريق
الطعام	طعام
الطعن	طعن
الطفل	طفل
الطفلة	طفل
الطفولة	طفولة
الطقس	طقس
الطلاب	طالب
الطلابية	طلابي
الطلاق	طلاق
الطلب	طلب
الطلبات	طلب
الطلبة	طالب
الطوائف	طائفة
الطوارئ	طوارئ
الطوال	طويل
الطول	طول
الطويل	طويل
الطويلة	طويل
الطيار	طيار
الطيارين	طيار
الطيب	طيب
الطيبة	طيب
الطيران	طيران
الطين	طين
الطيور	طير
الظالمين	ظالم
الظاهر	ظاهر
الظاهرة	ظاهر
الظروف	ظرف
الظل	ظل
الظلام	ظلام
الظلم	ظلم
الظهر	ظهر
الظهور	ظهور
الظواهري	ظاهرة
العائلات	عائلة
العائلة	عائلة
العاج	عاج
العاجلة	عاجل
العادة	عادة
العادي	عادي
العادية	عادي
العاشر	عاشر
العاشرة	عاشر
العاشق	عاشق
العاصفة	عاصفة
العاصمة	عاصمة
العاصمه	عاصم
العافية	عافية
العافيه	عافي
العالم	عالم
العالمي	عالم
العالمية	عالمي
العالمين	عالم
العالميه	عالم
العالي	عالي
العالية	عالي
العام	عام
العامة	عام
العامر	عامر
العامري	عامر
العامل	عامل
العاملة	عامل
العاملين	عامل
العامه	عام
العامين	عام
العاني	عاني
العاهرة	عاهرة
العاهل	عاهل
العبادي	عباد
العبارات	عبارة
العبارة	عبارة
العباسية	عباسي
العبث	عبث
العبد	عبد
العبرية	عبري
العبها	لعب
العبور	عبور
العثماني	عثماني
العثمانية	عثماني
العثور	عثور
العجز	عجز
العجمي	عجمي
العجوز	عجوز
العد	عد
العدالة	عدالة
العدد	عدد
العدل	عدل
العدو	عدو
العدوان	عدو
العدوي	عدو
العديد	عديد
العذاب	عذاب
العراقي	عراقي
العراقية	عراقي
العراقيين	عراقي
العرب	عربي
العربي	عربي
العربية	عربي
العرش	عرش
العرض	عرض
العروبة	عروبة
العروس	عروس
العروض	عرض
العريش	عريش
العز	عز
العزاء	عزاء
العزة	عزة
العزيز	عزيز
العسكر	عسكر
العسكري	عسكري
العسكرية	عسكري
العسكريين	عسكري
العسل	عسل
العشاء	عشاء
العشائر	عشيرة
العشر	عشر
العشرات	عشر
العشرة	عشر
العشرين	عشر
العشق	عشق
العشوائية	عشوائي
العصابات	عصابة
العصبي	عصب
العصبية	عصبي
العصر	عصر
العصور	عصر
العضلات	عضلة
العضو	عضو
العضوية	عضوية
العضويه	عضو
العطاء	عطاء
العطر	عطر
العطية	عطية
العظام	عظيم
العظيم	عظيم
العظيمة	عظيم
العفو	عفو
العقاب	عقاب
العقار	عقار
العقارات	عقار
العقاري	عقار
العقارية	عقاري
العقبة	عقبة
العقد	عقد
العقل	عقل
العقلية	عقلي
العقوبات	عقوبة
العقوبة	عقوبة
العقود	عقد
العقول	عقل
العقيد	عقيد
العقيدة	عقيدة
العكس	عكس
العلاج	علاج
العلاقات	علاقة
العلاقة	علاقة
العلامات	علامة
العلامة	علامة
العلم	علم
العلماء	عالم
العلمانية	علماني
العلمي	علم
العلمية	علمي
العلوم	علم
العلوي	علو
العلي	علي
العليا	علي
العم	عم
العمارة	عمارة
العمال	عامل
العمالة	عمالة
العماني	عماني
العمانية	عماني
العمانيون	عماني
العمانيين	عماني
العمر	عمر
العمرانية	عمراني
العمري	عمر
العمرية	عمري
العمق	عمق
العمل	عمل
العملاء	عميل
العملات	عملة
العملاق	عملاق
العملاقة	عملاق
العملة	عملة
العمليات	عملية
العملية	عملية
العمود	عمود
العموم	عم
العمومية	عمومي
العميد	عميد
العميق	عميق
العميل	عميل
العناصر	عنصر
العناوين	عنوان
العناية	عناية
العنزي	عنز
العنصر	عنصر
العنصري	عنصر
العنصرية	عنصري
العنف	عنف
العنوان	عنوان
العهد	عهد
العواصم	عاصمة
العواقب	عاقبة
العوامل	عامل
العود	عود
العودة	عودة
العوضي	عوض
العولمة	عولمة
العون	عون
العيب	عيب
العيد	عيد
العيش	عيش
العين	عين
العينين	عين
العيون	عين
الغابات	غابة
الغابة	غابة
الغارات	غارة
الغارة	غارة
الغارق	غارق
الغاز	غاز
الغالب	غالب
الغالي	غال
الغالية	غالي
الغد	غد
الغذاء	غذاء
الغذائي	غذائي
الغذائية	غذائي
الغرام	غرام
الغرامات	غرامة
الغرب	غرب
الغربه	غرب
الغربي	غرب
الغربية	غربي
الغرض	غرض
الغرف	غرفة
الغرفة	غرفة
الغريب	غريب
الغريبة	غريب
الغزالي	غزال
الغزو	غزو
الغش	غش
الغضب	غضب
الغلا	غل
الغلاف	غلاف
الغموض	غموض
الغنائي	غنائي
الغني	غني
الغنية	غني
الغور	غور
الغياب	غياب
الغيب	غيب
الغير	غير
الفئات	فئة
الفئة	فئة
الفائدة	فائدة
الفائز	فائز
الفائزين	فائز
الفارسي	فارسي
الفارغة	فارغ
الفارق	فارق
الفاروق	فاروق
الفاشلة	فاشل
الفاصل	فاصل
الفاضل	فاضل
الفاكهة	فاكهة
الفتاة	فتاة
الفتاح	فتاح
الفتح	فتح
الفترة	فترة
الفتره	فتر
الفتنة	فتنة
الفتوى	فتوى
الفتى	فتى
الفتيات	فتاة
الفجر	فجر
الفحص	فحص
الفحم	فحم
الفدرالية	فدرالي
الفراشات	فراشة
الفراشة	فراشة
الفراعنة	فرعون
الفراغ	فراغ
الفرج	فرج
الفرح	فرح
الفرد	فرد
الفردوس	فردوس
الفردي	فرد
الفردية	فردي
الفرسان	فرسان
الفرص	فرصة
الفرصة	فرصة
الفرع	فرع
الفرعية	فرعي
الفرق	فريق
الفرقة	فرقة
الفرنسي	فرنسي
الفرنسية	فرنسي
الفرنسيين	فرنسي
الفروسية	فروسية
الفريق	فريق
الفريقين	فريق
الفساد	فساد
الفشل	فشل
الفصائل	فصيل
الفصل	فصل
الفضائيات	فضائي
الفضائية	فضائي
الفضل	فضل
الفضيل	فضيل
الفطر	فطرة
الفعل	فعل
الفعلي	فعل
الفعلية	فعلي
الفقر	فقر
الفقراء	فقير
الفقري	فقر
الفقه	فقه
الفقير	فقير
الفقيرة	فقير
الفكر	فكر
الفكرة	فكرة
الفكره	فكر
الفكري	فكر
الفكرية	فكري
الفلسطيني	فلسطيني
الفلسطينية	فلسطيني
الفلسطينيون	فلسطيني
الفلسطينيين	فلسطيني
الفلسفة	فلسفة
الفم	فم
الفن	فن
الفنادق	فندق
الفنان	فنان
الفنانة	فنان
الفنانين	فنان
الفندق	فندق
الفنون	فن
الفني	فن
الفنية	فني
الفهم	فهم
الفوائد	فائدة
الفور	فور
الفوري	فور
الفورية	فوري
الفوز	فوز
الفيدرالية	فيدرالي
الفيديو	فيديو
الفيروس	فيروس
الفيروسات	فيروس
الفيصل	فيصل
الفيصلي	فيصل
الفيل	فيل
الفيلم	فيلم
القائد	قائد
القائم	قائم
القائمة	قائمة
القائمين	قائم
القاب	قاب
القابضة	قابض
القاتل	قاتل
القاتلة	قاتل
القادة	قائد
القادر	قادر
القادم	قادم
القادمة	قادم
القادمين	قادم
القارئ	قارئ
القارات	قارة
القارة	قارة
القاسم	قاسم
القاضي	قاضي
القاعدة	قاعدة
القاعده	قاعد
القالب	قالب
القانون	قانون
القانوني	قانون
القانونية	قانوني
القاهره	قاهر
القبائل	قبيلة
القبر	قبر
القبض	قبضة
القبول	قبول
القبيل	قبيل
القبيلة	قبيلة
القتال	قتال
القتل	قتل
القتلى	قتيل
القدر	قدرة
القدرات	قدرة
القدرة	قدرة
القدس	قدس
القدم	قدم
القدير	قدير
القديم	قديم
القديمة	قديم
القذافي	قذاف
القرآن	قرآن
القراءة	قراءة
القرار	قرار
القرارات	قرار
القراصنة	قرصان
القرص	قرص
القرعة	قرعة
القرم	قرمة
القرميد	قرميد
القرن	قرن
القروض	قرض
القروم	قرمة
القرى	قرية
القريب	قريب
القريبة	قريب
القرية	قرية
القسام	قسام
القسري	قسر
القسم	قسم
القصة	قصة
القصر	قصر
القصص	قصة
القصف	قصف
القصور	قصر
القصيدة	قصيدة
القصير	قصير
القصيرة	قصير
القصيم	قصيم
القضائية	قضائي
القضاة	قاضي
القضايا	قضية
القضية	قضية
القطار	قطر
القطارات	قطار
القطاع	قطاع
القطاعات	قطاع
القطب	قطب
القطري	قطر
القطرية	قطري
القطط	قط
القطع	قطع
القعدة	قعدة
القفز	قفز
القلب	قلب
القلعة	قلعة
القلق	قلق
القلم	قلم
القلوب	قلب
القليل	قليل
القليلة	قليل
القمامة	قمامة
القمة	قمة
القمح	قمح
القمر	قمر
القمع	قمع
القمه	قم
القنابل	قنبلة
القناة	قناة
القناه	لقن
القنبلة	قنبلة
القنوات	قناة
القهوة	قهوة
القوائم	قائمة
القوات	قوة
القواعد	قاعدة
القوالب	قالب
القوانين	قانون
القوة	قوة
القول	قول
القوم	قوم
القومي	قوم
القومية	قومي
القوى	قوة
القوي	قوي
القوية	قوي
القيادات	قيادة
القيادة	قيادة
القيادي	قيادي
القياسي	قياس
القياسية	قياسي
القيام	قيام
القيامة	قيامة
القيم	قيم
القيمة	قيم
القيود	قيد
الكأس	كأس
الكائنات	كائن
الكابتن	كابتن
الكاتب	كاتب
الكاتبة	كاتب
الكارثة	كارثة
الكافي	كافي
الكامل	كامل
الكاملة	كامل
الكبار	كبير
الكبد	كبد
الكبري	كبر
الكبير	كبير
الكبيرة	كبير
الكتاب	كاتب
الكتابة	كتابة
الكتابه	كاتب
الكتب	كتاب
الكتلة	كتلة
الكثافة	كثافة
الكثير	كثير
الكثيرة	كثير
الكثيرون	كثير
الكثيرين	كثير
الكحول	كحول
الكذب	كذب
الكراك	كرى
الكرام	كرام
الكرامة	كرامة
الكربون	كربون
الكرة	كرة
الكردستاني	كردستاني
الكردي	كردي
الكردية	كردي
الكرسي	كرسي
الكرك	كر
الكره	كر
الكروي	كروي
الكروية	كروي
الكريم	كريم
الكريمة	كريم
الكشف	كشف
الكعبة	كعبة
الكفاية	كفاية
الكل	كل
الكلاب	كلب
الكلام	كلام
الكلب	كلب
الكلك	كل
الكلمات	كلمة
الكلمة	كلمة
الكلمه	كلم
الكلي	كل
الكليات	كلية
الكلية	كلي
الكم	كم
الكمبيوتر	كمبيوتر
الكمية	كمية
الكنائس	كنيسة
الكندي	كندي
الكندية	كندي
الكنيسة	كنيسة
الكهرباء	كهرباء
الكهربائي	كهربائي
الكهربائية	كهربائي
الكهف	كهف
الكوادر	كوادر
الكوارث	كارثة
الكواكب	كوكب
الكود	كود
الكوري	كوري
الكورية	كوري
الكوكب	كوكب
الكون	كون
الكونفدرالية	كونفدرالي
الكويتي	كويتي
الكويتية	كويتي
الكيان	كيان
الكيك	كي
الكيميائي	كيميائي
الكيميائية	كيميائي
اللائحة	لائحة
اللاتينية	لاتيني
اللاجئين	لاجئ
اللازم	لازم
اللازمة	لازم
اللاعب	لاعب
اللاعبون	لاعب
اللاعبين	لاعب
اللبناني	لبناني
اللبنانية	لبناني
اللبنانيين	لبناني
اللتي	لت
اللجان	لجنة
اللجنة	لجنة
اللحظات	لحظة
اللحظة	لحظة
اللحم	لحم
اللحوم	لحم
اللسان	لسان
اللطيف	لطيف
اللعب	لعبة
اللعبة	لعبة
اللعبه	لعبة
اللعنة	لعنة
اللعنه	لعن
اللعين	لعين
اللغات	لغة
اللغة	لغة
اللقاء	لقاء
اللقاءات	لقاء
اللقب	لقب
اللمسة	لمسة
الله	الله
اللهم	لهم
اللواء	لواء
اللوحات	لوحة
اللوحة	لوحة
اللون	لون
اللي	لي
الليالي	ليلة
الليبي	ليبي
الليبية	ليبي
الليثي	ليث
الليل	ليل
الليلة	ليلة
الليله	ليل
الليمون	ليمون
المؤامرة	مؤامرة
المؤبد	مؤبد
المؤتمر	مؤتمر
المؤتمرات	مؤتمر
المؤسسات	مؤسس
المؤسسة	مؤسس
المؤشر	مؤشر
المؤشرات	مؤشر
المؤقت	مؤقت
المؤقتة	مؤقت
المؤكد	مؤكد
المؤلف	مؤلف
المؤمن	مؤمن
المؤمنين	مؤمن
المؤهلة	مؤهل
المئوية	مئوي
الماء	ماء
المائدة	مائدة
المائي	مائي
المائية	مائي
المادة	مادة
المادي	ماد
المادية	مادي
الماسي	ماس
الماضي	ماضي
الماضية	ماضي
الماضيين	ماضي
المال	مال
المالك	مال
المالكي	مالك
المالكين	مالك
المالي	مال
المالية	مالي
الماليزية	ماليزي
المباحث	مبحث
المبادئ	مبدأ
المبادرة	مبادرة
المباراة	مباراة
المبارك	مبارك
المباركة	مبارك
المباشر	مباشر
المباشرة	مباشر
المبالغ	مبلغ
المباني	مبنى
المبتدئين	مبتدئ
المبدع	مبدع
المبدعين	مبدع
المبرمج	مبرمج
المبعوث	مبعوث
المبكر	مبكر
المبكرة	مبكر
المبلغ	مبلغ
المبنى	مبنى
المبوبة	مبوب
المبيعات	مبيعات
المتابعة	متابع
المتابعين	متابع
المتاحة	متاح
المتبقية	متبقي
المتجددة	متجدد
المتجر	متجر
المتحدة	متحد
المتحدث	متحدث
المتحركة	متحرك
المتحف	متحف
المتخصصة	متخصص
المتداولة	متداول
المترتبة	مترتب
المترو	مترو
المتسابقين	متسابق
المتصاعد	متصاعد
المتصدر	متصدر
المتضررة	متضرر
المتطرف	متطرف
المتطرفة	متطرف
المتطرفون	متطرف
المتطرفين	متطرف
المتطور	متطور
المتطورة	متطور
المتطوعين	متطوع
المتظاهرون	متظاهر
المتظاهرين	متظاهر
المتعة	متعة
المتعددة	متعدد
المتعلقة	متعلق
المتفجرة	متفجر
المتقدم	متقدم
المتقدمة	متقدم
المتكاملة	متكامل
المتكررة	متكرر
المتمردين	متمرد
المتميز	متميز
المتميزة	متميز
المتنوعة	متنوع
المتهم	متهم
المتهمين	متهم
المتواجدون	متواجد
المتواجدين	متواجد
المتواصل	متواصل
المتوسط	متوسط
المتوسطة	متوسط
المتوفرة	متوفر
المتوقع	متوقع
المتوقعة	متوقع
المثال	مثال
المثالي	مثال
المثقفين	مثقف
المثل	مثل
المثير	مثير
المثيرة	مثير
المجازر	مجزرة
المجال	مجال
المجالات	مجال
المجالس	مجلس
المجالي	مجال
المجاني	مجان
المجانية	مجاني
المجاهدين	مجاهد
المجاورة	مجاور
المجتمع	مجتمع
المجتمعات	مجتمع
المجتمعية	مجتمعي
المجد	مجد
المجرم	مجرم
المجرمين	مجرم
المجلات	مجلة
المجلة	مجلة
المجلد	مجلد
المجلس	مجلس
المجمع	مجمع
المجموعات	مجموعة
المجموعة	مجموعة
المجموعه	مجموع
المجهر	مجهر
المجهود	مجهود
المجهول	مجهول
المجيد	مجيد
المحادثات	محادثة
المحادثة	محادثة
المحافظ	محافظ
المحافظات	محافظ
المحافظة	محافظ
المحافظين	محافظ
المحاكم	محكمة
المحاكمة	محاكمة
المحال	محال
المحامي	محامي
المحامين	محامي
المحاور	محور
المحاولات	محاولة
المحاولة	محاولة
المحبة	محب
المحبه	محب
المحتجين	محتج
المحترف	محترف
المحترفين	محترف
المحتل	محتل
المحتلة	محتل
المحتمل	محتمل
المحتوى	محتوى
المحتويات	محتوى
المحدد	محدد
المحددة	محدد
المحدود	محدود
المحرر	محرر
المحرك	محرك
المحروقات	محروق
المحطات	محطة
المحطة	محطة
المحقق	محقق
المحكمة	محكمة
المحل	محل
المحلات	محل
المحلة	محلة
المحلي	محلي
المحليات	محلي
المحلية	محلي
المحليين	محلي
المحمول	محمول
المحمولة	محمول
المحور	محور
المحيط	محيط
المحيطة	محيط
المخ	مخ
المخاطر	مخاطر
المخالفات	مخالف
المخالفة	مخالف
المخالفه	مخالف
المخاوف	مخاوف
المختص	مختص
المختصة	مختص
المختطفين	مختطف
المختلفة	مختلف
المخدرات	مخدر
المخرج	مخرج
المخصص	مخصص
المخصصة	مخصص
المخطط	مخطط
المخلص	مخلص
المخلوع	مخلوع
المخيم	مخيم
المد	مد
المدارس	مدرسة
المدافع	مدفع
المدة	مدة
المدخل	مدخل
المدرب	مدرب
المدربين	مدرب
المدرس	مدرس
المدرسة	مدرسة
المدرسي	مدرس
المدرسية	مدرسي
المدعي	مدعي
المدفوعة	مدفوع
المدمر	مدمر
المدن	مدينة
المدني	مدينة
المدنية	مدني
المدنيين	مدني
المدونة	مدون
المدى	مدية
المدير	مدير
المديرية	مديرية
المدينة	مدينة
المدينه	مدين
المذكور	مذكور
المذكورة	مذكور
المذهب	مذهب
المرء	مرء
المرأة	مرأة
المرات	مرة
المراحل	مرحلة
المراد	مراد
المراسلات	مراسل
المراسلين	مراسل
المرافق	مرفق
المراقبة	مراقب
المراقبين	مراقب
المراكز	مركز
المربع	مربع
المرة	مرة
المرتبة	مرتبة
المرتبطة	مرتبط
المرتفعة	مرتفع
المرتقبة	مرتقب
المرجح	مرجح
المرجعية	مرجعي
المرحلة	مرحلة
المرحله	مرحل
المرحوم	مرحوم
المرزوقي	مرزوق
المرسل	مرسل
المرشح	مرشح
المرشحين	مرشح
المرشد	مرشد
المرصد	مرصد
المرض	مرض
المرضى	مريض
المرفق	مرفق
المركبات	مركبة
المركبة	مركب
المركز	مركز
المركزي	مركز
المركزية	مركزي
المره	مر
المرور	مرور
المريض	مريض
المزاج	مزاج
المزارعين	مزارع
المزرعة	مزرعة
المزعجة	مزعج
المزيد	مزيد
المسألة	مسألة
المسؤول	مسؤول
المسؤولة	مسؤول
المسؤولون	مسؤول
المسؤولية	مسؤولية
المسؤولين	مسؤول
المسئولية	مسئولية
المساء	مساء
المسائل	مسألة
المسائي	مسائي
المسابقات	مسابقة
المسابقة	مسابقة
المساجد	مسجد
المساحة	مساح
المسار	مسار
المساعد	مساعد
المساعدات	مساعد
المساعدة	مساعد
المساعده	مساعد
المسافة	مسافة
المسافر	مسافر
المساهمة	مساهم
المساواة	مساواة
المستثمرين	مستثمر
المستحيل	مستحيل
المستخدم	مستخدم
المستخدمة	مستخدم
المستخدمين	مستخدم
المستدامة	مستدام
المستشار	مستشار
المستشفى	مستشفى
المستشفيات	مستشفى
المستقبل	مستقبل
المستقبلية	مستقبلي
المستقلة	مستقل
المستمر	مستمر
المستمرة	مستمر
المستهلك	مستهلك
المستوطنات	مستوطن
المستوطنون	مستوطن
المستوطنين	مستوطن
المستوى	مستوى
المستوي	مستوي
المستويات	مستوى
المسجد	مسجد
المسجلة	مسجل
المسجلين	مسجل
المسح	مسح
المسدس	مسدس
المسرح	مسرح
المسرحي	مسرح
المسرحية	مسرحية
المسلح	مسلح
المسلحة	مسلح
المسلحه	مسلح
المسلحين	مسلح
المسلسل	مسلسل
المسلسلات	مسلسل
المسلم	مسلم
المسلمة	مسلم
المسلمون	مسلم
المسلمين	مسلم
المسيح	مسيح
المسيحي	مسيحي
المسيحية	مسيحي
المسيحيين	مسيحي
المسيرة	مسيرة
المشارك	مشارك
المشاركات	مشارك
المشاركة	مشارك
المشاركه	مشارك
المشاركون	مشارك
المشاركين	مشارك
المشاريع	مشروع
المشاعر	شعور
المشاكل	مشكلة
المشاهد	مشاهد
المشاهدات	مشاهد
المشاهدة	مشاهد
المشتبه	مشتبه
المشترك	مشترك
المشتركة	مشترك
المشرف	مشرف
المشرفة	مشرف
المشرفين	مشرف
المشرق	مشرق
المشروع	مشروع
المشروعات	مشروع
المشكل	مشكل
المشكلات	مشكلة
المشكلة	مشكلة
المشكله	مشكل
المشهد	مشهد
المشهورة	مشهور
المشي	مش
المصاب	مصاب
المصابين	مصاب
المصادر	مصدر
المصارعة	مصارعة
المصارف	مصرف
المصالح	مصلحة
المصالحة	مصالحة
المصانع	مصنع
المصحف	مصحف
المصدر	مصدر
المصرف	مصرف
المصرفي	مصرف
المصرفية	مصرفي
المصري	مصري
المصرية	مصري
المصريون	مصري
المصريين	مصري
المصغرة	مصغر
المصفاة	مصفاة
المصلحة	مصلحة
المصلين	مصل
المصمم	مصمم
المصممة	مصمم
المصممين	مصمم
المصنع	مصنع
المصنف	مصنف
المصور	مصور
المصورة	مصور
المصير	مصير
المضادة	مضاد
المطار	مطار
المطارات	مطار
المطاعم	مطعم
المطاف	مطاف
المطالب	مطالب
المطالبة	مطالب
المطبخ	مطبخ
المطر	مطر
المطرب	مطرب
المطروحة	مطروح
المطعم	مطعم
المطلق	مطلق
المطلقة	مطلق
المطلوب	مطلوب
المطلوبة	مطلوب
المطور	مطور
المطيري	مطير
المظاهرات	مظاهرة
المظلوم	مظلوم
المظهر	مظهر
المعادلة	معادلة
المعادي	معادي
المعارض	معارض
المعارضة	معارض
المعارضين	معارض
المعارك	معركة
المعاصر	معاصر
المعاصرة	معاصر
المعاقين	معاق
المعاكس	معاكس
المعالج	معالج
المعالم	معلم
المعاملة	معاملة
المعاناة	معاناة
المعاني	معنى
المعايير	معيار
المعتقلين	معتقل
المعتمد	معتمد
المعتمدة	معتمد
المعدات	معد
المعدة	معد
المعدل	معدل
المعدنية	معدني
المعذرة	معذرة
المعرض	معرض
المعرفة	معرفة
المعركة	معركة
المعروف	معروف
المعروفة	معروف
المعزول	معزول
المعسكر	معسكر
المعظم	معظم
المعلم	معلم
المعلمين	معلم
المعلومات	معلومة
المعلوماتية	معلوماتية
المعلومة	معلومة
المعنى	معنى
المعنية	معني
المعهد	معهد
المعيشة	معيشة
المغاربة	مغربي
المغرب	مغرب
المغربي	مغرب
المغربية	مغربي
المغفور	مغفور
المغني	مغني
المفاتيح	مفتاح
المفاجأة	مفاجأة
المفاجئ	مفاجئ
المفاهيم	مفهوم
المفاوضات	مفاوض
المفتاح	مفتاح
المفترض	مفترض
المفتوح	مفتوح
المفتوحة	مفتوح
المفتي	مفتي
المفرق	مفرق
المفروض	مفروض
المفضل	مفضل
المفضلة	مفضل
المفقود	مفقود
المفوضية	مفوضية
المقابل	مقابل
المقابلة	مقابلة
المقاتلين	مقاتل
المقاس	مقاس
المقاصة	مقاصة
المقاطعة	مقاطعة
المقاعد	مقعد
المقال	مقال
المقالات	مقال
المقالة	مقالة
المقام	مقام
المقامة	مقام
المقاولون	مقاول
المقاومة	مقاوم
المقبل	مقبل
المقبلة	مقبل
المقدس	مقدس
المقدسة	مقدس
المقدسي	مقدسي
المقدم	مقدم
المقدمة	مقدم
المقر	مقر
المقربة	مقرب
المقرر	مقرر
المقررة	مقرر
المقصود	مقصود
المقطع	مقطع
المقلدة	مقلد
المقيمين	مقيم
المكاتب	مكتب
المكالمات	مكالمة
المكان	مكان
المكتب	مكتب
المكتبة	مكتبة
المكرمة	مكرم
المكون	مكون
المكونات	مكون
الملابس	ملابس
الملاحة	ملاح
الملاحظات	ملاحظ
الملازم	ملزمة
الملاعب	ملعب
الملاك	مل
الملاكمة	ملاكم
الملح	ملح
الملحق	ملحق
الملعب	ملعب
الملف	ملف
الملفات	ملف
الملك	ملك
الملكة	ملكة
الملكي	ملك
الملكية	ملكي
الملوك	ملك
الممارسات	ممارسة
الممانعة	ممانعة
الممتاز	ممتاز
الممتازة	ممتاز
الممثل	ممثل
الممثلة	ممثل
الممكن	ممكن
الممل	ممل
المملكة	مملكة
المميز	مميز
المميزات	مميز
المميزة	مميز
المناخ	مناخ
المنازل	منزل
المناسب	مناسب
المناسبات	مناسب
المناسبة	مناسب
المناصب	منصب
المناطق	منطقة
المناعة	مناعة
المنافس	منافس
المنافسات	منافس
المنافسة	منافس
المنافقين	منافق
المناهج	منهج
المنتج	منتج
المنتجات	منتج
المنتجة	منتج
المنتخب	منتخب
المنتخبات	منتخب
المنتدى	منتدى
المنتديات	منتدى
المنتشرة	منتشر
المنتصف	منتصف
المنتظر	منتظر
المنحل	منحل
المنخفض	منخفض
المندب	مندب
المنزل	منزل
المنزلي	منزل
المنزلية	منزلي
المنشآت	منشأة
المنشطات	منشط
المنشورة	منشور
المنصب	منصب
المنصور	منصور
المنصوره	منصور
المنطق	منطق
المنطقة	منطقة
المنطقه	منطق
المنظمات	منظم
المنظمة	منظم
المنظومة	منظومة
المنعم	منعم
المنكوبة	منكوب
المنورة	منور
المنوره	منور
المهاجر	مهاجر
المهاجرين	مهاجر
المهاجم	مهاجم
المهارات	مهارة
المهام	مهمة
المهدي	مهد
المهرجان	مهرجان
المهم	مهم
المهمة	مهم
المهنة	مهنة
المهندس	مهندس
المهندسين	مهندس
المهني	مهنة
المهنية	مهني
المواجهات	مواجهة
المواجهة	مواجهة
المواد	مادة
الموارد	مورد
الموازنة	موازنة
المواصلات	مواصلات
المواضيع	موضوع
المواطن	مواطن
المواطنة	مواطن
المواطنون	مواطن
المواطنين	مواطن
الموافق	موافق
الموافقة	موافق
المواقع	موقع
المواقف	موقف
الموالية	موالي
المواهب	موهبة
الموت	موت
الموتى	ميت
الموج	موج
الموجهة	موجه
الموجود	موجود
الموجودة	موجود
الموحد	موحد
الموريتاني	موريتاني
الموز	موزة
الموسم	موسم
الموسوعة	موسوعة
الموسيقي	موسيقي
الموسيقية	موسيقي
الموصل	موصل
الموضوع	موضوع
الموضوعات	موضوع
الموظف	موظف
الموظفين	موظف
الموعد	موعد
الموقع	موقع
الموقعة	موقع
الموقف	موقف
المولد	مولد
المياه	ماء
الميت	ميت
الميدان	ميدان
الميداني	ميدان
الميدانية	ميداني
الميزان	ميزان
الميزانية	ميزانية
الميلاد	ميلاد
الميلادي	ميلاد
الميناء	ميناء
النائب	نائب
الناتج	ناتج
الناتجة	ناتج
الناجح	ناجح
الناجحة	ناجح
الناجين	ناجي
الناحية	ناحية
الناخبين	ناخب
النادي	نادي
النار	نار
الناري	نار
النارية	ناري
النازحين	نازح
النازية	نازي
الناس	ناس
الناشئة	ناشئ
الناشئين	ناشئ
الناشر	ناشر
الناشط	ناشط
الناصر	ناصر
الناصرية	ناصري
الناطق	ناطق
النافذة	نافذة
الناقلة	ناقلة
النامية	نامي
النبوي	نبوي
النبوية	نبوي
النبي	نبي
النتائج	نتيجة
النتيجة	نتيجة
النجاة	نجاة
النجاح	نجاح
النجار	نجار
النجدة	نجدة
النجم	نجم
النجمة	نجم
النجوم	نجم
النحاس	نحاس
النحل	نحل
النحو	نحو
النخبة	نخبة
الندوة	ندوة
النزاع	نزاع
النساء	امرأة
النسائي	نسائي
النسائية	نسائي
النسبة	نسبة
النسخ	نسخة
النسخة	نسخة
النسخه	نسخة
النسر	نسر
النسور	نسر
النسوي	نسوي
النسوية	نسوي
النسيان	نسيان
النسيم	نسيم
النشاط	نشاط
النشاطات	نشاط
النشر	نشر
النشرات	نشرة
النشرة	نشرة
النشطاء	نشط
النص	نص
النصائح	نصيحة
النصال	نصل
النصب	نصب
النصر	نصر
النصرة	نصرة
النصف	نصف
النصوص	نص
النصيحة	نصيحة
النضال	نضال
النطاق	نطاق
النطاقات	نطاق
النطق	نطق
النظافة	نظافة
النظام	نظام
النظامية	نظامي
النظر	نظر
النظرة	نظرة
النظرية	نظري
النظم	نظام
النعيمي	نعيم
النفايات	نفاية
النفس	نفس
النفسي	نفس
النفسية	نفسي
النفط	نفط
النفطي	نفط
النفطية	نفطي
النفوذ	نفوذ
النفوس	نفس
النقاب	نقاب
النقابات	نقابة
النقابة	نقابة
النقاد	نقاد
النقاش	نقاش
النقاط	نقطة
النقد	نقد
النقدية	نقدي
النقض	نقض
النقطة	نقطة
النقل	نقل
النقيب	نقيب
النكبة	نكبة
النمر	نمر
النمسا	نمس
النمط	نمط
النمو	نمو
النموذج	نموذج
النهائي	نهائي
النهائية	نهائي
النهار	نهار
النهاية	نهاية
النهر	نهر
النهضة	نهضة
النهوض	نهوض
النواب	نائب
النور	نور
النوع	نوع
النوعية	نوعي
النوم	نوم
النووي	نووي
النووية	نووي
النيابة	نيابة
النيابية	نيابي
النية	نية
النيجيري	نيجيري
النيران	نار
النيل	نيل
الهاتف	هاتف
الهادئ	هادئ
الهادي	هادي
الهاشمي	هاشمي
الهاشمية	هاشمي
الهامة	هام
الهبوط	هبوط
الهجرة	هجرة
الهجري	هجر
الهجمات	هجوم
الهجوم	هجوم
الهجومية	هجومي
الهدافين	هداف
الهدايا	هدية
الهدف	هدف
الهدنة	هدنة
الهدى	هدى
الهرب	هرب
الهرم	هرم
الهروب	هروب
الهزائم	هزيمة
الهزيمة	هزيمة
الهلال	هلال
الهم	هم
الهندسة	هندسة
الهندسية	هندسي
الهندي	هندي
الهندية	هندي
الهوائية	هوائي
الهواتف	هاتف
الهوايات	هواية
الهولندي	هولندي
الهولندية	هولندي
الهوى	هوى
الهوية	هوية
الهيئات	هيئة
الهيئة	هيئة
الهيكل	هيكل
الواجب	واجب
الواجهة	واجهة
الواحد	واحد
الواحدة	واحد
الوادي	وادي
الواردة	وارد
الواسعة	واسع
الواضح	واضح
الواقع	واقع
الواقعة	واقع
الوالدين	والد
الوثائق	وثيقة
الوثائقية	وثائقي
الوثيقة	وثيقة
الوجبات	وجبة
الوجه	وجه
الوجود	وجود
الوجوه	وجه
الوحدات	وحدة
الوحدة	وحدة
الوحش	وحش
الوحيد	وحيد
الوحيدة	وحيد
الود	ود
الوداع	وداع
الودية	ودي
الورد	ورد
الوردي	ورد
الورق	ورق
الورقة	ورقة
الوزارات	وزارة
الوزارة	وزارة
الوزاري	وزاري
الوزراء	وزير
الوزن	وزن
الوزير	وزير
الوسائط	واسطة
الوسائل	وسيلة
الوساطة	وساطة
الوسام	وسام
الوسط	وسط
الوصف	وصف
الوصفة	وصفة
الوصول	وصول
الوضع	وضع
الوطن	وطن
الوطني	وطن
الوطنية	وطني
الوظائف	وظيفة
الوظيفة	وظيفة
الوعي	وعي
الوغد	وغد
الوفاء	وفاء
الوفاة	وفاة
الوفاق	وفاق
الوفد	وفد
الوفيات	وفي
الوقاية	وقاية
الوقت	وقت
الوقود	وقود
الوقوف	وقوف
الوكالة	وكالة
الوكيل	وكيل
الولادة	ولادة
الولايات	ولاية
الولاية	ولاية
الولد	ولد
الولي	ولي
الوليد	وليد
اليأس	يأس
الياباني	ياباني
اليابانية	ياباني
اليد	يد
اليدوية	يدوي
اليسار	يسار
اليقين	يقين
اليمن	يمن
اليمني	يمن
اليمنية	يمني
اليمنيين	يمني
اليمين	يمين
اليهود	يهودي
اليهودي	يهودي
اليهودية	يهودي
اليورو	يورو
اليوم	يوم
اليومي	يوم
اليومية	يومي
اليومين	يوم
اليوناني	يوناني
اليونانية	يوناني
امتحان	امتحان
امتحانات	امتحان
امتداد	امتداد
امتلاك	امتلاك
امتلك	امتلك
امرأة	امرأة
انتباه	انتباه
انتبه	انتبه
انتحاري	انتحاري
انتحارية	انتحاري
انتخاب	انتخاب
انتخابات	انتخاب
انتخابه	انتخاب
انتخابية	انتخابي
انتشار	انتشار
انتشال	انتشال
انتشرت	انتشر
انتصار	انتصار
انتصارات	انتصار
انتظار	انتظار
انتظر	انتظر
انتظري	انتظر
انتفاضة	انتفاضة
انتقاد	انتقاد
انتقادات	انتقاد
انتقال	انتقال
انتقام	انتقام
انتقد	انتقد
انتقل	انتقل
انتقلت	انتقل
انتهاك	انتهاك
انتهاكات	انتهاك
انتهت	انتهى
انتهى	انتهى
انتهيت	انتهى
انتهينا	انتهى
انحراف	انحراف
انحسر	انحسر
انخفاض	انخفاض
انخفض	انخفض
اندلاع	اندلاع
اندلعت	اندلع
انزل	نزل
انس	نسي
انسحاب	انسحاب
انشر	نشر
انصحك	نصح
انضم	انضم
انضمام	انضمام
انطلاق	انطلاق
انطلاقة	انطلاقة
انطلق	انطلق
انطلقت	انطلق
انظر	نظر
انظروا	نظر
انظري	نظر
انعدام	انعدام
انعقاد	انعقاد
انفجار	انفجار
انفجارات	انفجار
انفراد	انفراد
انقطاع	انقطاع
انقل	نقل
انقلاب	انقلاب
انهيار	انهيار
اهتمام	اهتمام
اهتماما	اهتمام
اهتمامات	اهتمام
ب	ب
بآخر	آخر
بأحد	أحد
بأس	أس
بأسرع	أسرع
بأسعار	سعر
بأسلوب	أسلوب
بأسماء	اسم
بأعمال	عمل
بأفضل	أفضل
بأقل	أقل
بأكثر	أكثر
بألمانيا	ألماني
بأمان	أمان
بأمر	أمر
بأمراض	مرض
بأنك	بأنك
بأننا	بأننا
بأنني	بأنني
بأنه	بأنه
بأنها	بأنها
بأنهم	بأنهم
بأهمية	أهمية
بأول	أول
بأي	أي
بإخراج	إخراج
بإدارة	إدارة
بإذن	إذن
بإرسال	إرسال
بإصدار	إصدار
بإطلاق	إطلاق
بإعادة	إعادة
بإغلاق	إغلاق
بإقامة	إقامة
بإمكان	إمكان
بإمكانك	إمكان
بإمكاني	إمكان
بإنشاء	إنشاء
بإيجاد	إيجاد
بإيصال	إيصال
بئر	بئر
بئس	بئس
بائع	بائع
باب	باب
بابا	باب
بات	بات
باتا	بات
باتاً	بات
باتت	بات
باتجاه	اتجاه
باتحاد	اتحاد
باتريك	باتر
باتوا	بات
باحث	باحث
باحثون	باحث
باختصار	اختصار
باختطاف	اختطاف
باختيار	اختيار
باخرة	باخرة
باد	باد
بار	بار
باراك	بار
بارتفاع	ارتفاع
بارتكاب	ارتكاب
بارد	بارد
باردة	بارد
بارز	بارز
بارك	بار
باستثناء	استثناء
باستخدام	استخدام
باستمرار	استمرار
باسل	باسل
باسم	اسم
باشا	باش
باص	باص
باعتبار	اعتبار
باعتباره	اعتبار
باعتبارها	اعتبار
بافتتاح	افتتاح
باقة	باقة
باقي	باقي
باكي	باكي
بال	بال
بالأسلحة	سلاح
بالأسماء	اسم
بالأقصر	أقصر
بالأمر	أمر
بالأمس	أمس
بالأنبار	نبر
بالأنبياء	نبي
بالإسلام	إسلام
بالإسماعيلية	إسماعيلية
بالإضافة	إضافة
بالإفراج	إفراج
بالإمكان	إمكان
بالإنجليزية	إنجليزي
بالالتحاق	التحاق
بالانتخابات	انتخاب
بالبحث	بحث
بالبحيرة	بحيرة
بالبرامج	برنامج
بالبراميل	برميل
بالبشرة	بشرة
بالبلاد	بلد
بالبيض	أبيض
بالتأكيد	تأكيد
بالتالي	تالي
بالتحديد	تحديد
بالتحقيق	تحقيق
بالتدخل	تدخل
بالتزامن	تزامن
بالتسجيل	تسجيل
بالتسمم	تسمم
بالتصميم	تصميم
بالتعادل	تعادل
بالتعاون	تعاون
بالتعويض	تعويض
بالتغلب	تغلب
بالتفصيل	تفصيل
بالتنحي	تنحي
بالتنسيق	تنسيق
بالتوفيق	توفيق
بالتوقيع	توقيع
بالجامعة	جامعة
بالجنوب	جنوب
بالجهاز	جهاز
بالجيش	جيش
بالحكم	حكم
بالحياة	حياة
بالخارج	خارج
بالخط	خط
بالخير	خير
بالداخل	داخل
بالدخول	دخول
بالدم	دم
بالدوري	دار
بالدولة	دولة
بالذات	ذات
بالذكر	ذكر
بالذكرى	ذكرى
بالرئيس	رئيس
بالرد	رد
بالرصاص	رصاصة
بالرغم	رغم
بالرياض	الرياض
بالساحل	ساحل
بالسجائر	سيجارة
بالسجن	سجن
بالسرطان	سرطان
بالسعودية	سعودي
بالسلاح	سلاح
بالسوق	سوق
بالشرقية	شرقي
بالشعر	شعر
بالشكل	شكل
بالصحة	صحة
بالصوت	صوت
بالصور	صورة
بالصورة	صورة
بالصوره	صورة
بالضبط	ضبط
بالضرب	ضرب
بالضرورة	ضرورة
بالضغط	ضغط
بالضفة	ضفة
بالطاقة	طاقة
بالطبع	طبع
بالطريق	طريق
بالطريقة	طريقة
بالعاصمة	عاصمة
بالعالم	عالم
بالعاهرة	عاهرة
بالعديد	عديد
بالعربي	عربي
بالعربية	عربي
بالعريش	عريش
بالعكس	عكس
بالعمل	عمل
بالعودة	عودة
بالعيد	عيد
بالغ	بالغ
بالغة	بالغ
بالغربية	غربي
بالفعل	فعل
بالفن	فن
بالفوز	فوز
بالفيديو	فيديو
بالقانون	قانون
بالقتل	قتل
بالقدس	قدس
بالقرب	قرب
بالقوة	قوة
بالقول	قول
بالك	بال
بالكاد	كاد
بالكامل	كامل
بالكثير	كثير
بالكرة	كرة
بالكلك	كل
باللغة	لغة
باللقب	لقب
بالله	الله
باللوم	لوم
باللون	لون
بالمؤبد	مؤبد
بالماء	ماء
بالمال	مال
بالمحافظات	محافظ
بالمحافظة	محافظ
بالمدرجات	مدرج
بالمدينة	مدينة
بالمركز	مركز
بالمساس	مساس
بالمساعدة	مساعد
بالمشاركة	مشارك
بالمعهد	معهد
بالمغرب	مغرب
بالمملكة	مملكة
بالمناسبة	مناسب
بالمنتدى	منتدى
بالمنزل	منزل
بالمنصة	منصة
بالمنطقة	منطقة
بالموضوع	موضوع
بالموقع	موقع
بالنادي	نادي
بالنسبة	نسبة
بالنسبه	نسبة
بالنظام	نظام
بالنظر	نظر
بالهاتف	هاتف
بالهجري	هجر
بالوادي	وادي
بالوكالة	وكالة
بالولايات	ولاية
بالي	بال
باليمن	يمن
باليوم	يوم
بان	بان
بانتخابات	انتخاب
بانتظار	انتظار
بانفجار	انفجار
ببراميل	برميل
ببرنامج	برنامج
ببساطة	بساطة
ببطء	ببطء
ببطولة	بطولة
ببعض	بعض
ببناء	بناء
ببني	بن
ببيع	بيع
بت	بت
بتاريخ	تاريخ
بتجارة	تجارة
بتحديد	تحديد
بتحقيق	تحقيق
بتحليل	تحليل
بتحميل	تحميل
بتحويل	تحويل
بترا	بتر
بترتيب	ترتيب
بتركيا	تركي
بترويج	ترويج
بتسجيل	تسجيل
بتسليم	تسليم
بتشكيل	تشكيل
بتصميم	تصميم
بتطبيق	تطبيق
بتطوير	تطوير
بتعديل	تعديل
بتعيين	تعيين
بتغيير	تغيير
بتفجير	تفجير
بتفجيرات	تفجير
بتقديم	تقديم
بتقنية	تقنية
بتكريم	تكريم
بتكلفة	تكلفة
بتلك	تل
بتمويل	تمويل
بتنظيم	تنظيم
بتنفيذ	تنفيذ
بتهمة	تهمة
بتوزيع	توزيع
بتوفير	توفير
بتوقيت	توقيت
بث	بث
بثلاثية	ثلاثي
بجائزة	جائزة
بجامعة	جامعة
بجانب	جانب
بجد	جد
بجدية	جدي
بجرائم	جريمة
بجروح	جرح
بجسر	جسر
بجلسة	جلسة
بجمهورية	جمهوري
بجميع	جميع
بجنوب	جنوب
بجوار	جوار
بجودة	جودة
بجولة	جولة
بحاجة	حاجة
بحاجه	حاج
بحادث	حادث
بحالة	حالة
بحب	حب
بحث	بحث
بحثا	بحث
بحثت	بحث
بحثية	بحثية
بحجة	حجة
بحجم	حجم
بحجمها	حجم
بحد	حد
بحذف	حذف
بحر	حر
بحري	حر
بحرية	حرية
بحريق	حريق
بحسب	حسب
بحضور	حضور
بحفظ	حفظ
بحق	حق
بحقهم	حق
بحقوق	حق
بحكم	حكم
بحل	حل
بحلب	حلب
بحلول	حل
بحماية	حماية
بحمد	حمد
بحمده	حمد
بحملة	حامل
بحوار	حوار
بحوالي	حوال
بحوزة	حوزة
بحوزته	حوزة
بحي	حي
بحياة	حياة
بحيرة	بحيرة
بخدمة	خدمة
بخصوص	خصوص
بخط	خط
بخلاف	خلاف
بخير	خير
بد	بد
بدء	بدء
بدءا	بدء
بدءاً	بدء
بدأ	بدأ
بدأت	بدأ
بدأنا	بدأ
بداخل	داخل
بداخله	داخل
بداخلها	داخل
بدار	دار
بدايات	بداية
بداية	بداية
بدت	بدا
بدخول	دخول
بدر	در
بدراسة	دراسة
بدرجة	درجة
بدستورية	دستوري
بدعم	دعم
بدعوة	دعوة
بدفع	دفع
بدقة	دقة
بدل	دل
بدلا	دل
بدلاً	دل
بدليل	دليل
بدور	دار
بدورة	دورة
بدوره	دار
بدورها	دار
بدوري	دار
بدول	دولة
بدولة	دولة
بدون	دون
بدوي	دوي
بدي	بد
بدير	دير
بديع	بديع
بديل	بديل
بديلا	بديل
بديلة	بديل
بذكرى	ذكرى
بذل	ذل
بذلك	ذل
بذور	بذرة
بر	بر
برأيك	رأي
برئاسة	رئاسة
برئيس	رئيس
براءة	براءة
برابط	رابط
برامج	برنامج
برامجنا	برنامج
برج	رج
برد	رد
برصاص	رصاصة
برصاصة	رصاصة
برصيد	رصيد
برعاية	رعاية
برغبة	رغبة
برغم	رغم
برفع	رفع
برفقة	رفقة
برق	رق
برقم	رقم
برقيات	برقية
برقية	برقية
بركة	بركة
بركن	ركن
برلمان	برلمان
برلمانيه	برلمان
برمجة	برمجة
برمجه	برمج
برميل	برميل
برنامج	برنامج
برنامجا	برنامج
برنامجه	برنامج
برنامجها	برنامج
برنس	برنس
بروابط	رابط
بروتوكول	بروتوكول
بروح	روح
بروس	روسي
برومو	رومي
برومين	رومي
بري	بر
برية	بري
بريت	برى
بريد	بريد
بريدي	بريد
بريدية	بريدي
بريس	ريس
بريف	ريف
بريك	ري
بزلزال	زلزال
بزمن	زمن
بزيادة	زيادة
بزيارة	زيارة
بس	باس
بساطة	بساطة
بسام	سام
بسبب	سبب
بسجن	سجن
بسجون	سجن
بسحب	سحب
بسرطان	سرطان
بسرعة	سرعة
بسرعه	سرع
بسرقة	سرقة
بسرقتها	سرقة
بسعر	سعر
بسقوط	سقوط
بسكين	سكين
بسلاح	سلاح
بسلام	سلام
بسم	سم
بسمة	سمة
بسهولة	سهولة
بسوريا	سوري
بسيارات	سيارة
بسيارة	سيارة
بسيط	بسيط
بسيطة	بسيط
بشأن	شأن
بشأنه	شأن
بشارع	شارع
بشاشة	شاشة
بشدة	شدة
بشر	شر
بشراء	شراء
بشرط	شرط
بشركة	شركة
بشروط	شرط
بشرى	شرى
بشري	شر
بشرية	بشرية
بشفافية	شفافية
بشكل	شكل
بشمال	شمال
بشيء	شيء
بشير	بشير
بص	بص
بصحة	صحة
بصداع	صداع
بصدد	صدد
بصراحة	صراحة
بصراحه	صراح
بصرف	صرف
بصعوبة	صعوبة
بصفة	صفة
بصمة	صمة
بصوت	صوت
بصور	صورة
بصورة	صورة
بصيغة	صيغة
بضرورة	ضرورة
بضع	بضع
بضعة	ضعة
بضعف	ضعف
بطارية	بطارية
بطاقات	طاقة
بطاقة	طاقة
بطبيعة	طبيعة
بطرق	طريقة
بطريق	طريق
بطريقة	طريقة
بطريقه	طريق
بطل	بطل
بطلا	بطل
بطلب	طلب
بطن	طن
بطول	طول
بطولات	بطولة
بطولة	بطولة
بطوله	طول
بعث	بعث
بعثة	بعثة
بعد	عد
بعدة	عدة
بعدد	عدد
بعدم	عدم
بعدما	عدم
بعدن	بعد
بعده	عد
بعدها	عد
بعدين	بعد
بعرض	عرض
بعض	بعض
بعضا	بعض
بعضنا	بعض
بعضها	بعض
بعضهم	بعض
بعضوية	عضوية
بعقد	عقد
بعقوبة	عقوبة
بعمان	عم
بعمل	عمل
بعمليات	عملية
بعملية	عملية
بعنوان	عنوان
بعودة	عودة
بعيد	عيد
بعيدا	عيد
بعيداً	عيد
بعيدة	بعيد
بعين	عين
بغاز	غاز
بغرض	غرض
بغرق	غرق
بغض	بغض
بغيت	بغى
بغير	غير
بفارق	فارق
بفتح	فتح
بفرض	فرض
بفضل	فضل
بفعل	فعل
بفكرة	فكرة
بفوز	فوز
بفوزه	فوز
بقاعدة	قاعدة
بقانون	قانون
بقايا	بقية
بقتل	قتل
بقدر	قدرة
بقرار	قرار
بقرية	قرية
بقسم	قسم
بقصر	قصر
بقصف	قصف
بقضية	قضية
بقطاع	قطاع
بقطع	قطع
بقلم	قلم
بقليل	قليل
بقنا	بق
بقناة	قناة
بقوات	قوة
بقوة	قوة
بقول	قول
بقوله	قول
بقي	بقي
بقيادة	قيادة
بقية	بقية
بقيت	بقي
بقيم	قيم
بقيمة	قيم
بك	ب
بكأس	كأس
بكار	كار
بكافة	كافة
بكامل	كامل
بكتابة	كتابة
بكثرة	كثرة
بكثير	كثير
بكر	كر
بكرة	كرة
بكسل	كسل
بكفر	كفر
بكل	كل
بكلمات	كلمة
بكلمة	كلمة
بكلية	كلي
بكم	ب
بكين	بكى
بل	بل
بلا	بل
بلاد	بلد
بلادنا	بلد
بلاده	بلد
بلادها	بلد
بلادهم	بلد
بلادي	بلد
بلاغ	بلاغ
بلاك	بل
بلد	بلد
بلدان	بلد
بلدة	لدة
بلدنا	بلد
بلده	بلد
بلدي	بلد
بلدية	بلدي
بلغ	بلغ
بلغة	لغة
بلغت	بلغ
بلقاء	لقاء
بلقب	لقب
بلوحة	لوحة
بلوغ	بلوغ
بلون	لون
بليبيا	ليبي
بليغة	بليغ
بلينكن	لين
بما	ما
بماذا	بماذا
بمبلغ	مبلغ
بمثابة	مثابة
بمثل	مثل
بمجرد	مجرد
بمجلس	مجلس
بمحافظة	محافظ
بمحاولة	محاولة
بمحطة	محطة
بمحيط	محيط
بمختلف	مختلف
بمداهمة	مداهمة
بمدرسة	مدرسة
بمديرية	مديرية
بمدينة	مدينة
بمدينه	مدين
بمرج	مرج
بمرض	مرض
بمركبة	مركب
بمركز	مركز
بمرور	مرور
بمسابقة	مسابقة
بمساحة	مساح
بمساعدة	مساعد
بمستشفى	مستشفى
بمستوى	مستوى
بمسقط	مسقط
بمسيرة	مسيرة
بمشاركة	مشارك
بمشاكل	مشكلة
بمشروع	مشروع
بمصر	مصر
بمطار	مطار
بمعارك	معركة
بمعدل	معدل
بمعرض	معرض
بمعنى	معنى
بمعهد	معهد
بمقابل	مقابل
بمقتل	مقتل
بمقدار	مقدار
بمقر	مقر
بمكان	مكان
بملاحقة	ملاحق
بملف	ملف
بمن	من
بمناسبة	مناسب
بمنتدى	منتدى
بمنطقة	منطقة
بمنع	منع
بمهرجان	مهرجان
بمواجهة	مواجهة
بموجب	موجب
بموضوع	موضوع
بموقع	موقع
بموقعك	موقع
بميدان	ميدان
بن	بن
بنا	ب
بناء	بناء
بنات	ابن
بنادي	نادي
بنت	بان
بنتائج	نتيجة
بنتيجة	نتيجة
بنجاح	نجاح
بنحو	نحو
بندر	ندر
بندقية	بندقية
بنسبة	نسبة
بنسبه	نسبة
بنشر	نشر
بنظام	نظام
بنغازي	بنغازي
بنفس	نفس
بنفسك	نفس
بنفسه	نفس
بنفسها	نفس
بنفسي	نفس
بنقل	نقل
بنك	بن
بنها	بن
بنهاية	نهاية
بنود	بند
بنوك	بنى
بنى	بنى
بني	بن
بنية	بني
به	ب
بها	ب
بهجمات	هجوم
بهجوم	هجوم
بهدف	هدف
بهدفين	هدف
بهم	ب
بهما	ب
بهمة	همة
بوابة	بواب
بواسطة	واسطة
بواقع	واقع
بوب	بوب
بوبي	بوب
بوتين	وتين
بوجه	وجه
بوجود	وجود
بود	ود
بورصة	بورصة
بوزارة	وزارة
بوسط	وسط
بوسعي	وسع
بوش	بوش
بوصلة	وصلة
بوضع	وضع
بوضوح	وضوح
بوقت	وقت
بوقف	وقف
بوكس	وكس
بول	بول
بولاية	ولاية
بي	ب
بيئة	بيئة
بيان	بيان
بيانا	بيان
بيانات	بيان
بياناتي	بيان
بيت	بيت
بيتا	بيت
بيتك	بيت
بيتنا	بيت
بيته	بيت
بيتي	بيت
بيد	يد
بيده	يد
بيض	أبيض
بيضاء	أبيض
بيع	بيع
بيعها	بيع
بيك	بيك
بيكون	يكون
بيل	بيل
بيلي	بيل
بين	بين
بينك	بين
بينما	بينما
بيننا	بين
بينه	بين
بينها	بين
بينهم	بين
بينهما	بين
بيني	بين
بيوت	بيت
بيوم	يوم
تأتي	أتى
تأثر	أثار
تأثير	تأثير
تأثيرات	تأثير
تأجير	تأجير
تأجيل	تأجيل
تأخذ	أخذ
تأخر	تأخر
تأخرت	تأخر
تأخير	تأخير
تأسست	تأسس
تأسيس	تأسيس
تأشيرة	تأشيرة
تأطير	تأطير
تأكد	تأكد
تأكل	أكل
تأكيد	تأكيد
تألق	ألق
تأليف	تأليف
تأمل	أمل
تأمين	أم
تأهب	أهاب
تأهل	أهل
تأهيل	تأهيل
تأييد	تأييد
تؤثر	أثر
تؤجج	أجج
تؤدي	أدى
تؤكد	أكد
تؤمن	أامن
تؤيد	أيد
تابع	تابع
تابعة	تابع
تابعنا	تابع
تاج	تاج
تاجر	تاجر
تاريخ	تاريخ
تاريخه	تاريخ
تاريخها	تاريخ
تاريخي	تاريخ
تاريخية	تاريخي
تام	تام
تامة	تام
تبا	تب
تبادل	تبادل
تبارك	بارك
تباشر	باشر
تباين	باين
تباً	تب
تبث	بث
تبحث	بحث
تبدأ	بدأ
تبدو	بدا
تبدين	بدا
تبرئ	أبرأ
تبرز	أبرز
تبع	بيع
تبعد	بعد
تبقى	بقي
تبقي	بقي
تبكي	بكى
تبلغ	بلغ
تبليغ	تبليغ
تبني	بين
تبهر	بهر
تبوك	تب
تبي	تب
تبيع	بيع
تبين	بين
تتأهب	أهاب
تتأهل	أهل
تتابع	تابع
تتبرع	تبرع
تتبع	بيع
تتبنى	بنى
تتجاوز	تجاوز
تتجه	اتجه
تتحدث	حدث
تتحرك	تحرك
تتحقق	حقق
تتحكم	حكم
تتحمل	تحمل
تتحول	حول
تتخذ	اتخذ
تتخطى	خطا
تتداول	تداول
تتدخل	دخل
تتذكر	ذكر
تتراجع	تراجع
تتراوح	تراوح
تتردد	تردد
تترك	رك
تتسبب	سبب
تتصدر	صدر
تتصدى	صدى
تتصل	صلى
تتضمن	ضام
تتطلب	طلب
تتطلع	اطلع
تتعامل	عامل
تتعرض	عرض
تتعلق	تعلق
تتعلم	علم
تتعهد	عهد
تتغير	غير
تتقدم	قدم
تتكرر	كرر
تتكلم	كلم
تتكون	كان
تتم	ما
تتمتع	تمتع
تتمثل	مثل
تتمكن	ما
تتميز	تميز
تتناقل	تناقل
تتناقله	تناقل
تتناول	تناول
تتهم	هم
تتواصل	تواصل
تتوفر	أوفر
تتوقع	وقع
تتوقف	توقف
تتولى	ولى
تتويج	تتويج
تثبت	ثبت
تثبيت	تثبيت
تثق	وثق
تثير	أثار
تجار	جار
تجارب	تجربة
تجارة	تجارة
تجاري	جار
تجارية	تجاري
تجاه	تجاه
تجاهل	تجاهل
تجاوز	تجاوز
تجاوزت	تجاوز
تجتمع	اجتمع
تجد	جد
تجدد	جدد
تجده	جد
تجدها	جد
تجديد	تجديد
تجذب	جذب
تجربة	تجربة
تجربته	تجربة
تجربتي	تجربة
تجربه	جرب
تجرى	أجرى
تجري	جار
تجسس	تجسس
تجعل	جعل
تجلس	جلس
تجمع	جمع
تجمعات	تجمع
تجميد	تجميد
تجميع	تجميع
تجميل	تجميل
تجنب	جنب
تجهيز	تجهيز
تجوب	جاب
تجيب	أجاب
تحارب	حارب
تحاصر	حاصر
تحالف	تحالف
تحاول	حاول
تحب	حب
تحبه	حب
تحت	حت
تحتاج	احتاج
تحترم	احترم
تحتضن	احتضن
تحتفظ	احتفظ
تحتفل	احتفل
تحتفي	احتفى
تحتل	احتل
تحتوي	احتوى
تحد	حد
تحدث	حدث
تحدثت	تحدث
تحدد	حدد
تحدي	حد
تحديات	تحدي
تحديث	تحديث
تحديد	تحديد
تحديدا	تحديد
تحذر	حذار
تحذير	حذار
تحذيرات	تحذير
تحرك	حر
تحركات	تحرك
تحركاتك	تحرك
تحركوا	تحرك
تحرم	حرم
تحرير	تحرير
تحريرها	تحرير
تحريك	حار
تحسن	حسن
تحسين	حس
تحصد	حصد
تحصل	حصل
تحضر	حضر
تحضيراته	تحضير
تحط	حط
تحطم	حطم
تحطيم	تحطيم
تحظى	حظي
تحفظ	حفظ
تحقق	حقق
تحققت	تحقق
تحقيق	تحقيق
تحقيقا	تحقيق
تحقيقات	تحقيق
تحكم	حكم
تحكمه	حكم
تحكي	حك
تحكيم	تحكيم
تحل	حل
تحليل	تحليل
تحمل	تحمل
تحمي	حمى
تحميل	تحميل
تحول	حول
تحولت	تحول
تحوي	حوى
تحويل	تحويل
تحيا	حي
تحيات	تحية
تحياتي	تحية
تحية	تحية
تحيتي	تحية
تحيه	حي
تحيي	حي
تخاف	خاف
تخبرني	خبر
تختار	اختار
تختتم	اختتم
تختص	اختص
تختلف	اختلف
تخدم	خدم
تخرج	خرج
تخريج	تخريج
تخزين	تخزين
تخسر	خسر
تخشى	خشي
تخص	خص
تخصص	خصص
تخصيص	تخصيص
تخضع	خضع
تخطئ	أخطأ
تخطط	خطط
تخطي	خط
تخطيط	تخطيط
تخفيض	تخفيض
تخفيضات	تخفيض
تخفيف	تخفيف
تخلص	تخلص
تخلي	خل
تخوض	خوض
تخيل	خيل
تدابير	تدابير
تدافع	دافع
تداول	تداول
تداولته	تداول
تدخل	دخل
تدرس	درس
تدرك	در
تدري	دار
تدريب	تدريب
تدريبات	تدريب
تدريباته	تدريب
تدريبي	تدريب
تدريبية	تدريبي
تدريجيا	تدريجي
تدريس	تدريس
تدشين	دش
تدعم	دعم
تدعو	دعا
تدعى	دعا
تدعي	دعا
تدفع	دفع
تدفق	تدفق
تدل	دل
تدمر	دمر
تدمره	دمر
تدمير	تدمير
تدهور	تدهور
تدور	دار
تدوير	تدوير
تدين	ودى
تذاكر	تذكرة
تذكر	ذكر
تذكرة	تذكرة
تذهب	ذهب
ترأس	رأس
تراث	تراث
تراجع	تراجع
تراجعت	تراجع
تراخيص	ترخيص
تراه	رأى
تربط	ربط
تربية	تربية
ترتبط	ارتبط
ترتدي	ارتدى
ترتفع	ارتفع
ترتيب	ترتيب
ترتيبات	ترتيب
ترجع	رجع
ترجمة	ترجمة
ترجيح	ترجيح
ترحب	رحب
ترحل	رحل
ترحيب	ترحيب
ترخيص	ترخيص
ترد	رد
تردد	تردد
ترسل	أرسل
ترشح	ترشح
ترشيح	ترشيح
ترشيحات	ترشيح
ترصد	رصد
ترصدان	رصد
ترعى	رعى
ترغب	رغب
ترفض	رفض
ترفع	رفع
ترفيه	رف
ترفيهيه	ترفيهي
ترقية	ترقية
ترقيع	ترقيع
ترقيه	راق
ترك	رك
تركب	ركب
تركت	ترك
تركز	ركز
تركي	رك
تركيا	تركي
تركيب	تركيب
تركيبه	تركيب
تركية	تركي
تركيز	تركيز
تروح	روح
ترى	رأى
تري	رأى
تريد	أراد
تريدني	أراد
تريده	أراد
تريدون	أراد
تريدين	أراد
تريكة	تريكة
تريليون	تريليون
تزال	زال
تزامنا	زام
تزايد	زايد
تزداد	ازداد
تزوجت	تزوج
تزور	زار
تزويد	تزويد
تزوير	تزوير
تزيد	زاد
تسأل	سأل
تساؤلات	تساؤل
تساعد	ساعد
تساعدوني	ساعد
تساقط	تساقط
تساهم	ساهم
تساوي	ساوى
تسبب	سبب
تسببت	تسبب
تسبق	سبق
تستأنف	استأنف
تستحق	استحق
تستخدم	استخدم
تستدعي	استدعى
تستضيف	استضاف
تستطع	استطاع
تستطيع	استطاع
تستطيعين	استطاع
تستعد	استعاد
تستعرض	استعرض
تستعمل	استعمل
تستعيد	استعاد
تستغرق	استغرق
تستغل	استغل
تستقبل	استقبل
تستمر	استمر
تستمع	استمع
تستهدف	استهدف
تسجل	سجل
تسجيل	تسجيل
تسحب	سحب
تسديد	تسديد
تسرب	سرب
تسريب	تسريب
تسريبات	تسريب
تسريع	تسريع
تسع	سعى
تسعة	تسع
تسعى	سعى
تسعين	سعى
تسقط	سقط
تسلح	سلح
تسلل	تسلل
تسلم	سلم
تسليح	تسليح
تسليم	تسليم
تسمح	سمح
تسمع	سمع
تسمم	تسمم
تسمى	سمى
تسمية	تسمية
تسهم	سهم
تسهيل	تسهيل
تسوي	سوى
تسوية	تسوية
تسويق	تسويق
تسير	سير
تسيطر	سيطر
تشاء	شاء
تشارك	شارك
تشاهد	شاهد
تشبه	شاب
تشتري	اشترى
تشتغل	اشتغل
تشجيع	تشجيع
تشخيص	تشخيص
تشرب	شرب
تشرح	شرح
تشرين	شرى
تشعر	شعر
تشعل	أشعل
تشغل	شغل
تشغيل	تشغيل
تشكر	شكر
تشكل	شكل
تشكيل	تشكيل
تشكيلة	تشكيلة
تشمل	شمل
تشن	شن
تشهد	شهد
تشهدها	شهد
تشوف	شوف
تشير	أشار
تشييع	تشييع
تصادم	تصادم
تصاعد	تصاعد
تصاعدي	تصاعد
تصاميم	تصميم
تصب	أصاب
تصبح	صبح
تصحيح	تصحيح
تصدر	صدر
تصدق	صدق
تصدير	تصدير
تصرف	صرف
تصريح	تصريح
تصريحات	تصريح
تصريحاته	تصريح
تصعيد	تصعيد
تصغير	تصغير
تصفح	صفح
تصفع	صفع
تصفية	تصفية
تصل	صلى
تصلح	صلح
تصميم	تصميم
تصميمي	تصميم
تصنع	صنع
تصنيع	تصنيع
تصنيف	تصنيف
تصور	صور
تصويب	تصويب
تصويت	تصويت
تصوير	تصوير
تصويري	تصوير
تصيب	أصاب
تصير	صار
تضامنية	تضامني
تضبط	ضبط
تضحك	ضحك
تضرب	ضرب
تضررا	تضرر
تضع	وضع
تضغط	ضغط
تضفي	أضفى
تضم	ضام
تضمن	ضام
تضمنت	تضمن
تضيع	ضيع
تضيف	أضاف
تطالب	طالب
تطبق	طبق
تطبيق	تطبيق
تطبيقات	تطبيق
تطبيقها	تطبيق
تطرح	طرح
تطرق	طرق
تطلب	طلب
تطلع	اطلع
تطلق	طلق
تطهير	تطهير
تطور	تطور
تطورات	تطور
تطوروا	تطور
تطوعية	تطوعي
تطوير	تطوير
تظاهرات	تظاهرة
تظل	ظل
تظلم	ظلم
تظن	ظن
تظهر	ظهر
تعادل	عادل
تعارض	عارض
تعاطي	تعاطي
تعال	أعال
تعالوا	أعال
تعالى	تعالى
تعالي	أعال
تعامل	عامل
تعاني	عانى
تعاون	تعاون
تعاوني	تعاون
تعاين	عاين
تعب	عب
تعبئة	تعبئة
تعبت	تعب
تعبر	عبر
تعبير	تعبير
تعتبر	اعتبر
تعترف	اعترف
تعتزم	اعتزم
تعتقد	اعتقد
تعتقدين	اعتقد
تعتقل	اعتقل
تعتمد	اعتمد
تعثر	عثر
تعجبكم	أعجب
تعد	عد
تعداد	تعداد
تعدد	تعدد
تعدل	عدل
تعديل	تعديل
تعديلات	تعديل
تعذيب	تعذيب
تعرض	عرض
تعرضت	تعرض
تعرضه	عرض
تعرف	عرف
تعرفه	عرف
تعرفها	عرف
تعرفون	عرف
تعرفي	عرف
تعرفين	عرف
تعريب	تعريب
تعريف	تعريف
تعريفها	تعريف
تعز	عز
تعزز	عزز
تعزيز	تعزيز
تعزيزات	تعزيز
تعطل	عطل
تعطي	أمنى
تعطيل	تعطيل
تعطيني	أمنى
تعفي	عف
تعقد	عقد
تعكس	عكس
تعلق	تعلق
تعلم	علم
تعلمت	تعلم
تعلمون	علم
تعلمين	علم
تعلن	عال
تعليق	تعليق
تعليقا	تعليق
تعليقات	تعليق
تعليقك	تعليق
تعليم	تعليم
تعليمي	تعليمي
تعليمية	تعليمي
تعمل	عمل
تعنى	عنى
تعني	عن
تعهد	عهد
تعود	عاد
تعويض	تعويض
تعيد	عيد
تعيش	عاش
تعيين	أعيى
تغادر	غادر
تغذية	تغذية
تغريد	تغريدة
تغضب	غضب
تغطي	غطى
تغطية	تغطية
تغلب	غلب
تغلق	غلق
تغني	غني
تغيب	غاب
تغير	غير
تغيرت	تغير
تغيير	تغيير
تغييرات	تغيير
تفاصيل	تفاصيل
تفاعل	فاعل
تفاقم	فاقم
تفاهم	تف
تفتتح	افتتح
تفتح	فتح
تفتيش	تفتيش
تفجر	فجر
تفجير	تفجير
تفجيرات	تفجير
تفرض	فرض
تفرق	فرق
تفسر	فسر
تفسير	تفسير
تفضل	فضل
تفضلوا	فضل
تفعل	فعل
تفعله	فعل
تفعلونه	فعل
تفعلي	فعل
تفعلين	فعل
تفعيل	تفعيل
تفقد	فقد
تفقدية	تفقدي
تفكر	فكر
تفكك	فك
تفكير	تفكير
تفكيك	فك
تفهم	فهم
تفوز	فاز
تفوزان	فاز
تفوق	فاق
تفوقها	فوق
تفيد	أفاد
تقاتل	قاتل
تقارير	تقرير
تقام	أقام
تقبل	قبل
تقترب	اقترب
تقتصر	اقتصر
تقتل	قتل
تقدر	قدر
تقدم	قدم
تقدما	قدم
تقدمت	تقدم
تقدمه	قدم
تقدمها	قدم
تقدير	تقدير
تقديرا	تقدير
تقديم	تقديم
تقر	قرى
تقرأ	قرأ
تقرر	قرر
تقريبا	تقريب
تقريباً	تقريب
تقرير	تقرير
تقريرا	تقرير
تقسيم	تقسيم
تقص	أقصى
تقصد	قصد
تقصف	قصف
تقضي	قضى
تقطع	قطع
تقطن	قط
تقطيع	تقطيع
تقع	وقع
تقف	وقف
تقل	قال
تقلق	قلق
تقلقي	قلق
تقلل	قلل
تقليد	تقليد
تقليص	تقليص
تقليل	تقليل
تقم	قام
تقني	تقني
تقنيات	تقنية
تقنية	تقنية
تقنيه	قنا
تقود	قاد
تقوده	قاد
تقول	قال
تقوله	قال
تقولي	قال
تقولين	قال
تقوم	قام
تقوية	تقوية
تقيم	قيم
تقييم	تقييم
تك	وكى
تكاد	كاد
تكاليف	تكلفة
تكبير	تكبير
تكتب	كتب
تكتشف	اكتشف
تكتم	تك
تكثيف	تكثيف
تكدس	تكدس
تكذب	كذب
تكرار	تكرار
تكرر	كرر
تكرم	كرم
تكريم	تكريم
تكريما	تكريم
تكسب	كسب
تكشف	كشف
تكفون	كفى
تكفي	كفى
تكلف	كلف
تكلفة	تكلفة
تكلم	كلم
تكمن	كم
تكن	كان
تكنولوجيا	تكنولوجي
تكون	كان
تكونوا	كان
تكوني	كان
تكوين	كوى
تل	ولى
تلاقي	لاقى
تلبية	تلبية
تلبيس	تلبيس
تلتقي	التقى
تلعب	لعب
تلغى	لغا
تلغي	لغا
تلف	لاف
تلفزيون	تلفزيون
تلفزيونية	تلفزيوني
تلقائي	تلقائي
تلقائيا	تلقائي
تلقائياً	تلقائي
تلقت	تلقى
تلقى	لقي
تلقي	لقي
تلقيت	تلقى
تلك	ولى
تلو	لوى
تلوث	تلوث
تلوين	لوى
تم	ما
تمارس	مارس
تمارين	مار
تمام	تمام
تماما	تمام
تماماً	تمام
تمت	تم
تمتد	امتد
تمتع	تمتع
تمتلك	امتلك
تمثال	تمثال
تمثل	مثل
تمثيل	تمثيل
تمدد	مدد
تمديد	تمديد
تمر	أمار
تمرد	تمرد
تمزح	مزح
تمسك	ماس
تمكن	ما
تمكنت	تمكن
تمكين	تمكين
تملك	ملك
تمنح	منح
تمنع	منع
تمهيدا	تمهيد
تموت	موت
تمويل	تمويل
تميز	تميز
تمييز	تمييز
تنازلي	تنازل
تناسب	تناسب
تنافس	تنافس
تناقش	ناقش
تنال	نال
تنام	نام
تنامي	نام
تناول	تناول
تناولت	تناول
تنبيه	نبي
تنتج	أنتج
تنتشر	انتشر
تنتظر	انتظر
تنتقد	انتقد
تنتقل	انتقل
تنتمي	انتمى
تنتهز	انتهز
تنتهي	انتهى
تنجح	نجح
تنجو	نجا
تنديدا	تنديد
تنزل	نزل
تنزيل	تنزيل
تنس	ناس
تنسى	نسي
تنسيق	تنسيق
تنشر	نشر
تنشيط	تنشيط
تنصيب	تنصيب
تنضم	انضم
تنطلق	انطلق
تنظر	نظر
تنظم	نظم
تنظيف	تنظيف
تنظيم	تنظيم
تنفذ	نفذ
تنفع	نفع
تنفق	نفق
تنفي	نفى
تنفيذ	تنفيذ
تنفيذه	تنفيذ
تنفيذها	تنفيذ
تنقذ	نقذ
تنقل	نقل
تنمية	تنمية
تنهي	نها
تنوي	نوى
تهاجم	هاجم
تهتم	اهتم
تهدد	هدد
تهدف	هدف
تهديد	تهديد
تهديدات	تهديد
تهرب	هرب
تهريب	تهريب
تهم	هم
تهمة	تهمة
تهمك	هم
تهميش	تهميش
تهنئة	تهنئة
تهيئة	تهيئة
تو	تو
تواجد	تواجد
تواجه	واجه
تواجهه	واجه
توازن	وازن
تواصل	تواصل
تواصلت	تواصل
توافق	وافق
تواقيع	توقيع
توب	توب
توتر	وتر
توثيق	توثيق
توج	توج
توجد	أوجد
توجه	وجه
توجيه	توجيه
توجيهي	توجيه
توحيد	توحيد
تود	ود
تورط	تورط
توريد	توريد
توزع	وزع
توزيع	توزيع
توسع	وسع
توسيع	توسيع
توصل	توصل
توصلت	توصل
توصيات	توصية
توصيل	توصيل
توضح	وضح
توضع	وضع
توضيح	توضيح
توظيف	توظيف
توفر	أوفر
توفي	وفى
توفير	توفير
توفيق	توفيق
توقع	وقع
توقعات	توقع
توقعت	توقع
توقف	توقف
توقفت	توقف
توقفوا	توقف
توقفي	وقف
توقيت	توقيت
توقيع	توقيع
توقيف	توقيف
توك	تو
تولى	ولى
تولي	ولى
توليد	توليد
توليه	أولى
تونسي	تونسي
توني	ونى
تيار	تيار
تيارات	تيار
تيسير	تيسير
تيم	تيم
ثابت	ثاب
ثابتة	ثابت
ثالث	ثالث
ثالثا	ثالث
ثالثة	ثالث
ثان	ثاني
ثانوية	ثانوي
ثاني	ثاني
ثانيا	ثاني
ثانياً	ثاني
ثانية	ثاني
ثبت	ثبت
ثروة	ثروة
ثري	ثر
ثعبان	ثعبان
ثغرات	ثغرة
ثغرة	ثغرة
ثقافة	ثقافة
ثقافي	ثقافي
ثقافية	ثقافي
ثقة	ثقة
ثقيلة	ثقيل
ثلاث	ثلاث
ثلاثة	ثلاث
ثلاثي	ثلاث
ثلاثية	ثلاث
ثلاثين	ثلاث
ثلث	ثلث
ثلثا	ثلث
ثلوج	ثلج
ثم	ثم
ثماني	ثمان
ثمانية	ثمان
ثمانيني	ثمانين
ثمن	ثمن
ثمنها	ثمن
ثمين	ثمين
ثنائي	ثنائي
ثنائية	ثنائي
ثوار	ثائر
ثواني	ثانية
ثورات	ثورة
ثورة	ثورة
جئت	جاء
جاء	جاء
جاءت	جاء
جائزة	جائزة
جابر	جابر
جاد	جاد
جادة	جاد
جار	جار
جاري	جار
جارية	جاري
جالس	جالس
جامع	جامع
جامعات	جامعة
جامعة	جامعة
جامعه	جامع
جان	جاني
جانب	جانب
جانبه	جانب
جانبها	جانب
جانبي	جانب
جاهز	جاهز
جاهزة	جاهز
جاهزون	جاهز
جبال	جبل
جبل	جبل
جبهة	جبهة
جبهتي	جبهة
جثة	جثة
جثث	جثة
جثمان	جثمان
جد	جد
جدا	جد
جداا	جدا
جدار	جدار
جداول	جدول
جداً	جد
جدة	جدة
جدد	جديد
جدران	جدار
جدل	جدل
جدلا	جدل
جده	جد
جدها	جد
جدول	جدول
جدي	جد
جدية	جدي
جديد	جديد
جديدا	جديد
جديداً	جديد
جديدة	جديد
جذب	جذب
جرائم	جريمة
جراح	جرح
جراحة	جراح
جراحية	جراحي
جرام	جرام
جرب	جرب
جربت	جرب
جرت	جار
جرح	جرح
جرحى	جريح
جرش	جرش
جروح	جرح
جرى	جرى
جريح	جريح
جريحا	جريح
جريدة	جريدة
جريده	جريد
جريمة	جريمة
جزء	جزء
جزءا	جزء
جزءاً	جزء
جزئي	جزئي
جزائري	جزائري
جزائريين	جزائري
جزاك	جزى
جزاكم	جزى
جزر	جزيرة
جزيرة	جزيرة
جسد	جسد
جسدي	جسد
جسر	جسر
جسم	جسم
جعل	جعل
جعلت	جعل
جعله	جعل
جعلها	جعل
جل	جل
جلال	جلال
جلالة	جلالة
جلالته	جلالة
جلب	جلب
جلسات	جلسة
جلسة	جلسة
جماعات	جماعة
جماعة	جماعة
جماعه	جماع
جماعي	جماعي
جماعية	جماعي
جمال	جملة
جماهير	جماهير
جمع	جمع
جمعة	جمعة
جمعت	جمع
جمعيات	جمعية
جمعية	جمعية
جملة	جملة
جمهور	جمهور
جمهورية	جمهوري
جميع	جميع
جميعا	جميع
جميعاً	جميع
جميعنا	جميع
جميعها	جميع
جميعهم	جميع
جميل	جميل
جميلة	جميل
جنائية	جنائي
جناح	جناح
جنازة	جنازة
جنايات	جناية
جنب	جنب
جنة	جنة
جندي	جندي
جنديا	جندي
جنرال	جنرال
جنس	جنس
جنسية	جنسي
جنوب	جنوب
جنوبي	جنوب
جنود	جندي
جنون	جنون
جنين	جنا
جنيه	جنيه
جنيها	جنيه
جنيهات	جنيه
جهات	جهة
جهاد	جهاد
جهاز	جهاز
جهازك	جهاز
جهازي	جهاز
جهة	جهة
جهته	جهة
جهتها	جهة
جهد	جهد
جهود	جهد
جهودها	جهد
جو	جو
جوائز	جائزة
جواب	جواب
جواد	جواد
جواز	جواز
جوازات	جواز
جوال	جوال
جوانب	جانب
جوبا	جوب
جوت	جوت
جودة	جودة
جوز	جوز
جوزيه	جوزي
جول	جول
جولات	جولة
جولة	جولة
جولته	جولة
جون	جون
جوني	جون
جوهر	جوهر
جوي	جو
جوية	جوي
جيب	جيب
جيد	جيد
جيدا	جيد
جيداً	جيد
جيدة	جيد
جيري	جار
جيش	جيش
جيشنا	جيش
جيل	جيل
جيم	جيم
جيمي	جيم
جين	جين
جيوش	جيش
حائل	حائل
حاجة	حاجة
حاجز	حاجز
حاجه	حاج
حاد	حاد
حادة	حاد
حادث	حادث
حادثة	حادثة
حار	حار
حارة	حار
حارس	حارس
حازم	حازم
حاسب	حاسب
حاسمة	حاسم
حاسوب	حاسوب
حاصل	حاصل
حاضر	حاضر
حاضرة	حاضر
حاضنة	حاضنة
حافة	حافة
حافظ	حافظ
حافلات	حافلة
حافلة	حافلة
حاكم	حاكم
حال	حال
حالا	حال
حالات	حالة
حالاً	حال
حالة	حالة
حالته	حالة
حالك	حال
حالكم	حال
حالما	حالم
حاله	حال
حاليا	حالي
حالياً	حالي
حامل	حامل
حاملة	حامل
حامية	حامي
حان	حان
حاول	حاول
حاولت	حاول
حاولوا	حاول
حب	حب
حباً	حب
حبس	حبس
حبك	حب
حبه	حب
حبوب	حب
حبي	حب
حبيب	حبيب
حبيبتي	حبيب
حبيبه	حبيب
حبيبي	حبيب
حتى	حتى
حج	حج
حجازي	حجازي
حجب	حجاب
حجة	حجة
حجر	حجر
حجز	حجز
حجم	حجم
حجمه	حجم
حجمها	حجم
حد	حد
حدا	حد
حدائق	حديقة
حداد	حداد
حدة	حدة
حدث	حدث
حدثت	حدث
حدثنا	حدث
حدد	حدد
حددت	حد
حدوث	حدوث
حدود	حد
حدودها	حد
حديث	حديث
حديثا	حديث
حديثة	حديث
حديثه	حديث
حديد	حديد
حديقة	حديقة
حذاء	حذاء
حذر	حذر
حذرت	حذار
حذف	حذف
حذفت	حذف
حر	حر
حرا	حر
حرائق	حريق
حرارة	حرارة
حراس	حارس
حراسة	حراسة
حراك	حرى
حرام	حرام
حرامي	حرام
حرب	حرب
حربا	حرب
حربية	حربي
حرة	حر
حرس	حارس
حرص	حرص
حرف	حرفة
حرق	حرق
حركات	حركة
حركة	حركة
حركه	حرك
حرم	حرم
حرمان	حرمان
حره	حر
حروب	حرب
حروف	حرفة
حرية	حرية
حريق	حريق
حريقا	حريق
حزام	حزام
حزب	حزب
حزبه	حزب
حزم	حزمة
حزمة	حزمة
حزن	حزن
حزين	حزين
حساب	حساب
حسابات	حساب
حسابك	حساب
حسابه	حساب
حسابي	حساب
حساسة	حساس
حساسية	حساسية
حسام	حسام
حسان	حسا
حسب	حسب
حسبنا	حسب
حسبي	حسب
حسم	حسم
حسن	حسن
حسنا	حسن
حسناً	حسن
حسنة	حسن
حسني	حسن
حسين	حسا
حشد	حشد
حشيش	حشيش
حصاد	حصاد
حصار	حصار
حصان	حصان
حصة	حصة
حصد	حصد
حصر	حصر
حصري	حصري
حصريا	حصري
حصرياً	حصري
حصرية	حصري
حصل	حصل
حصلت	حصل
حصلنا	حصل
حصول	حصول
حصيلة	حصيلة
حضارة	حضارة
حضر	حضر
حضرة	حضرة
حضرت	حضر
حضرتك	حضر
حضور	حضور
حط	حط
حظ	حظ
حظا	حظ
حظر	حظر
حظك	حظ
حفاظا	حفاظ
حفر	حفرة
حفظ	حفظ
حفظه	حفظ
حفل	حفل
حفلا	حفل
حفلات	حفل
حفلة	حفلة
حفيد	حفيد
حق	حق
حقا	حق
حقائق	حقيقة
حقاً	حق
حقق	حقق
حققت	حق
حققه	حقق
حقك	حق
حقل	حقل
حقه	حق
حقها	حق
حقوق	حق
حقوقهم	حق
حقوقية	حقوقي
حقول	حقل
حقي	حق
حقيبة	حقيبة
حقيرة	حقير
حقيقة	حقيقة
حقيقي	حقيقي
حقيقية	حقيقي
حكام	حكم
حكايات	حكاية
حكاية	حكاية
حكم	حكم
حكما	حكم
حكمة	حكمة
حكمت	حكم
حكمه	حكم
حكومات	حكومة
حكومة	حكومة
حكومته	حكومة
حكومي	حكومي
حكومية	حكومي
حكيم	حكيم
حل	حل
حلا	حل
حلال	حلال
حلب	حلب
حلبة	حلبة
حلف	حلف
حلقات	حلقة
حلقة	حلقة
حلم	حلم
حلمي	حلم
حله	حل
حلها	حل
حلو	حلو
حلوان	حلوان
حلول	حل
حلوه	حل
حليب	حليب
حماة	حماة
حمار	حمار
حماس	حماس
حماسة	حماسة
حمام	حمام
حماية	حماية
حمد	حمد
حمدي	حمد
حمراء	أحمر
حمص	حمص
حمل	حمل
حملات	حملة
حملة	حامل
حملت	حمل
حملته	حمل
حمله	حمل
حمود	حمود
حمى	حمى
حميد	حميد
حنا	حان
حنان	حنان
حنين	حنين
حواجز	حاجز
حوادث	حادث
حوار	حوار
حوارا	حوار
حوارات	حوار
حوارية	حواري
حوالي	حوال
حوض	حوض
حول	حول
حولك	حول
حوله	حول
حولها	حول
حولي	حول
حي	حي
حيا	حي
حياة	حياة
حياتك	حياة
حياتنا	حياة
حياته	حياة
حياتها	حياة
حياتهم	حياة
حياتهن	حياة
حياتي	حياة
حياك	حي
حياكم	حي
حياه	حي
حياً	حي
حية	حي
حيث	حيث
حيثيات	حيثية
حيز	حاز
حين	حي
حينما	حينما
حينها	حين
حيوان	حيوان
حيوانات	حيوان
حيوية	حيوي
خائف	خائف
خائفة	خائف
خاتم	خاتم
خادم	خادم
خارج	خارج
خارجي	خارجي
خارجية	خارجي
خارطة	خارطة
خاص	خاص
خاصا	خاص
خاصة	خاص
خاصية	خاصية
خاض	خاض
خاطئ	خاطئ
خاطئة	خاطئ
خالد	خالد
خالص	خالص
خالي	خال
خالية	خالي
خام	خام
خامس	خامس
خان	خان
خانة	خانة
خانه	خان
خبر	خبر
خبراء	خبير
خبرات	خبرة
خبرة	خبرة
خبره	خبر
خبير	خبير
ختام	ختام
ختم	ختم
خدمات	خدمة
خدماتنا	خدمة
خدمة	خدمة
خدمه	خدم
خذ	أخذ
خذي	أخذ
خرائط	خريطة
خرج	خرج
خرجت	خرج
خروج	خروج
خروجه	خروج
خريطة	خريطة
خسائر	خسارة
خسارة	خسارة
خسارته	خسارة
خسر	خسر
خسرت	خسر
خشية	خشية
خصص	خصص
خصم	خصم
خصوصا	خصوص
خصوصاً	خصوص
خصوصية	خصوصية
خضر	أخضر
خضراء	أخضر
خط	خط
خطأ	خطأ
خطاب	خطاب
خطابا	خطاب
خطب	خطبة
خطبة	خطبة
خطة	خطة
خطر	خطر
خطرا	خطر
خطط	خطة
خطف	خطف
خطوات	خطوة
خطوة	خطوة
خطورة	خطورة
خطوط	خط
خطى	خطوة
خطي	خط
خطيب	خطيب
خطير	خطير
خطيرة	خطير
خفض	خفض
خفيف	خفيف
خفيفة	خفيف
خلاص	خلاص
خلاف	خلاف
خلافات	خلاف
خلال	خلال
خلاله	خلال
خلالها	خلال
خلايا	خلية
خلع	خلع
خلف	خلف
خلفا	خلف
خلفه	خلف
خلفيات	خلفية
خلفية	خلفية
خلق	خلق
خلقه	خلق
خلل	خلل
خلية	خلية
خليج	خليج
خليجي	خليج
خليجية	خليجي
خليفة	خليفة
خليك	خلي
خليل	خليل
خماسي	خمس
خمس	خمس
خمسة	خمس
خمسين	خمس
خميس	خميس
خواطر	خاطرة
خوان	خوان
خور	خور
خوض	خوض
خوف	خوف
خوفا	خوف
خيار	خيار
خيارات	خيار
خيال	خيال
خيالي	خيال
خيالية	خيالي
خيبة	خيبة
خير	خير
خيرا	خير
خيراً	خير
خيري	خير
خيرية	خيري
دائرة	دائرة
دائم	دائم
دائما	دائم
دائماً	دائم
دائمة	دائم
داخل	داخل
داخله	داخل
داخلي	داخل
داخلية	داخلي
دار	دار
دارت	دار
داعي	داعي
داعيا	داعي
دافع	دافع
دام	دام
دامت	دام
دان	دان
دبابات	دبابة
دبلوماسي	دبلوماسي
دبلوماسية	دبلوماسي
دبي	دب
دخل	دخل
دخلت	دخل
دخول	دخول
دخولك	دخول
دخولي	دخول
دراجة	دراجة
دراسات	دراسة
دراسة	دراسة
دراسته	دراسة
درب	درب
درجات	درجة
درجة	درجة
دردشة	دردشة
دردشه	دردش
درس	درس
درع	درع
درعا	درع
درهم	در
دروب	درب
دروس	درس
درويش	درويش
دستور	دستور
دستورية	دستوري
دع	دع
دعا	دعا
دعاء	دعاء
دعاية	دعاية
دعت	دعا
دعم	دعم
دعما	دعم
دعمه	دعم
دعمها	دعم
دعنا	دع
دعني	دع
دعوات	دعوة
دعواتكم	دعوة
دعوة	دعوة
دعونا	دعا
دعوه	دعا
دعينا	دعا
دفا	دف
دفاع	دفاع
دفاعا	دفاع
دفع	دفع
دفعة	دفعة
دفعت	دفع
دفعه	دفع
دفن	دف
دقائق	دقيقة
دقة	دقة
دقيق	دقيق
دقيقة	دقيقة
دقيقتين	دقيقة
دكتور	دكتور
دل	دل
دلالات	دلال
دلع	دلع
دليل	دليل
دم	دم
دماء	دم
دمار	دمار
دمت	دم
دمتم	دم
دمج	دمج
دمر	دمر
دمرت	دمر
دمعة	دمعة
دموع	دمعة
دمي	دم
دنيا	دني
دهس	دهس
دهسا	دهس
دهم	دهم
دواء	دواء
دوائر	دائرة
دوت	دوى
دور	دار
دورا	دار
دورات	دورة
دوراً	دار
دورة	دورة
دورته	دور
دوره	دار
دورها	دار
دوري	دار
دورية	دوري
دول	دولة
دولار	دولار
دولارا	دولار
دولارات	دولار
دولارين	دولار
دولة	دولة
دولتهم	دولة
دوله	دولة
دولي	دولة
دوليا	دولي
دولية	دولي
دوليون	دولي
دوما	دوم
دوماً	دوم
دون	دون
دوي	دوي
ديانا	ديان
ديانات	ديان
دير	دير
ديس	داس
ديكور	ديكور
ديلي	دال
ديمقراطية	ديمقراطي
دين	دين
دينا	دين
دينار	دينار
دينارا	دينار
ديني	دين
دينية	ديني
ديوان	ديوان
ديون	دين
ذا	هذا
ذات	ذات
ذاته	ذات
ذاتها	ذات
ذاتية	ذاتي
ذاك	ذلك
ذاكرة	ذاكرة
ذالك	ذال
ذاهب	ذاهب
ذبحني	ذبح
ذكر	ذكر
ذكرت	ذكر
ذكره	ذكر
ذكرها	ذكر
ذكرى	ذكرى
ذكري	ذكر
ذكريات	ذكرى
ذكي	ذكي
ذكية	ذكي
ذلك	ذل
ذمة	ذمة
ذنب	ذنب
ذهاب	ذهاب
ذهب	ذهب
ذهبت	ذهب
ذهبية	ذهبي
ذو	ذو
ذوق	ذوق
ذوي	ذو
ذي	ذو
رأت	رأى
رأس	رأس
رأسك	رأس
رأسه	رأس
رأسها	رأس
رأسهم	رأس
رأسي	رأس
رأفت	رأف
رأى	رأى
رأي	رأي
رأيت	رأى
رأيته	رأى
رأيك	رأي
رأيكم	رأي
رأينا	رأي
رأيه	رأي
رأيي	رأي
رؤساء	رئيس
رؤوس	رأس
رؤى	رؤية
رؤية	رؤية
رؤيتك	رؤية
رؤيته	رؤية
رئاسة	رئاسة
رئاسية	رئاسي
رئة	رئة
رئيس	رئيس
رئيسا	رئيس
رئيساً	رئيس
رئيسة	رئيس
رئيسي	رئيس
رئيسية	رئيسي
رائج	رائج
رائحة	رائحة
رائد	رائد
رائع	رائع
رائعا	رائع
رائعاً	رائع
رائعة	رائع
رائعه	رائع
رابط	رابط
رابطة	رابطة
رابع	رابع
رابعة	رابع
راتب	راتب
راجع	راجع
راجعون	راجع
راجل	راجل
راح	راح
راحة	راحة
راحت	راح
راحل	راحل
راسلنا	راسل
راسلني	راسل
راشد	راشد
راصد	راصد
راضي	راضي
راعي	راع
راغب	راغب
رافضي	رافض
راقب	راقب
راكب	راكب
راكباً	راكب
رالي	رالي
رام	رام
رانك	ران
راية	راية
رب	رب
رباعي	ربع
رباعية	أربع
ربح	ربح
ربط	ربط
ربع	ربع
ربك	رب
ربما	ربما
ربنا	رب
ربه	رب
ربوع	ربوع
ربى	ربى
ربي	رب
ربيع	ربيع
رتب	رتبة
رجال	رجل
رجب	رجب
رجع	رجع
رجعت	رجع
رجل	رجل
رجلا	رجل
رجلاً	رجل
رجلي	رجل
رجيم	رجيم
رحال	رحال
رحب	رحب
رحت	راح
رحل	رحل
رحلات	رحلة
رحلة	رحلة
رحلت	رحل
رحم	رحم
رحمة	رحمة
رحمه	رحم
رحيل	رحيل
رحيله	رحيل
رخصة	رخصة
رد	رد
ردا	رد
ردة	ردة
ردح	ردح
ردك	رد
ردود	رد
ردي	رد
رزق	رزق
رسائل	رسالة
رسالة	رسالة
رسالتك	رسالة
رسام	رسام
رسم	رسم
رسما	رسم
رسمي	رسم
رسميا	رسمي
رسمياً	رسمي
رسمية	رسمي
رسميه	رسم
رسول	رسول
رسوم	رسم
رشق	رشق
رشيد	رشيد
رصاصة	رصاصة
رصد	رصد
رصيد	رصيد
رصيده	رصيد
رصيف	رصيف
رضا	رض
رضوان	رضوان
رضي	رض
رعاية	رعاية
رعب	رعب
رعد	رعد
رعدية	رعدي
رعى	رعى
رغبة	رغبة
رغبته	رغبة
رغم	رغم
رفاق	رفيق
رفض	رفض
رفضت	رفض
رفضه	رفض
رفضوا	رفض
رفع	رفع
رفعت	رفع
رفعها	رفع
رفيع	رفيع
رفيق	رفيق
رقابة	رقابة
رقص	رقص
رقم	رقم
رقما	رقم
رقمي	رقم
ركاب	راكب
ركب	ركب
ركبت	ركب
ركز	ركز
ركن	ركن
رمز	رمز
رمزي	رمزي
رمزية	رمزي
رمزيه	رمز
رمضاني	رمضاني
رمضانية	رمضاني
رموز	رمز
رهيب	رهيب
رهيبة	رهيب
رهينة	رهينة
روائع	رائعة
روابط	رابط
رواتب	راتب
رواد	رائد
رواه	روى
روايات	رواية
رواية	رواية
روبن	روب
روتانا	روى
روح	روح
روحاني	روح
روحي	روح
روز	روز
روس	روسي
روسي	روسي
روسيا	روسي
روسية	روسي
روعة	روعة
روعه	روع
روق	روق
رولا	رول
روما	روم
رومانسي	رومانسي
رومانيا	روماني
روي	روى
رياح	ريح
رياضات	رياضة
رياضة	رياضة
رياضي	رياضي
رياضية	رياضي
ريال	ريال
ريان	ريان
ريحانا	ريح
ريد	راد
ريف	ريف
ريم	ريم
زائر	زائر
زائفة	زائف
زاد	زاد
زادت	زاد
زار	زار
زارها	زار
زال	زال
زالت	زال
زالوا	زال
زاهر	زاهر
زاوية	زاوية
زايد	زايد
زج	زج
زحمة	زحمة
زخرف	زخرف
زر	زر
زراعة	زراعة
زراعية	زراعي
زرع	زرع
زعامة	زعامة
زعماء	زعيم
زعيم	زعيم
زفاف	زفاف
زكي	زكى
زلت	زال
زلزال	زلزال
زمالك	زامل
زمان	زمان
زمن	زمن
زمنية	زمني
زميله	زميل
زهرة	زهرة
زواج	زوج
زوار	زائر
زواريب	زاروب
زوج	زوج
زوجة	زوج
زوجتك	زوج
زوجته	زوج
زوجتي	زوج
زوجك	زوج
زوجها	زوج
زوجي	زوج
زورق	زورق
زي	زي
زيادة	زيادة
زيارات	زيارة
زيارة	زيارة
زيارته	زيارة
زيت	زيت
زيد	زاد
زين	زين
زينة	زينة
سأتصل	اتصل
سأخبرك	خبر
سأخوض	خوض
سأذهب	ذهب
سأعود	عاد
سأفعل	فعل
سأقول	قال
سأقوم	قام
سأكون	كان
سألت	لت
سؤال	سؤال
سؤالي	سؤال
سئل	سأل
سائح	سائح
سائر	سائر
سائق	سائق
سابق	سابق
سابقا	سابق
سابقاً	سابق
سابقة	سابق
سابك	ساب
سات	سات
ساحة	ساحة
ساحر	ساحر
ساحل	ساحل
ساخن	ساخن
ساخنة	ساخن
سار	سار
سارع	سارع
ساره	سار
ساري	سار
ساسة	سياسي
ساعات	ساعة
ساعة	ساعة
ساعتين	ساعة
ساعد	ساعد
ساعدت	ساعد
ساعدني	ساعد
ساعدوني	ساعد
سافر	سافر
سالم	سالم
سام	سام
سامح	سامح
سامي	سام
ساميا	سامي
سامية	سامي
ساهر	ساهر
ساهم	ساهم
ساهمت	ساهم
سب	سب
سباق	سباق
سباقات	سباق
سبب	سبب
سببا	سبب
سبحان	سبحان
سبحانك	سبحان
سبحانه	سبحان
سبع	سبع
سبعة	سبع
سبعين	سبع
سبق	سبق
سبل	سبيل
سبورتانا	سبورة
سبيل	سبيل
ست	ست
ستار	ستار
ستبدأ	بدأ
ستبقى	بقي
ستة	ست
ستجد	جد
ستذهب	ذهب
ستستمر	استمر
ستصبح	صبح
ستظهر	ظهر
ستعمل	عمل
ستعود	عاد
ستفعل	فعل
ستقام	أقام
ستقوم	قام
ستكون	كان
ستين	ست
سجل	سجل
سجلات	سجل
سجلت	سجل
سجله	سجل
سجن	سجن
سجناء	سجين
سجون	سجن
سجين	سجين
سحاب	سحابة
سحب	سحب
سحر	سحر
سخرية	سخرية
سخيف	سخيف
سد	سد
سدة	سدة
سر	سر
سراج	سراج
سراح	سراح
سرايا	سرية
سرت	سار
سرحان	سرحان
سرطان	سرطان
سرعان	سرعان
سرعة	سرعة
سرعه	سرع
سرق	سرق
سرقة	سرقة
سرور	سرور
سري	سر
سرية	سري
سريع	سريع
سريعا	سريع
سريعاً	سريع
سريعة	سريع
سطح	سطح
سعادة	سعادة
سعادته	سعادة
سعة	سعة
سعد	سعد
سعداء	سعيد
سعر	سعر
سعره	سعر
سعود	سعود
سعودي	سعودي
سعودية	سعودي
سعوديين	سعودي
سعيد	سعيد
سعيداً	سعيد
سعيدة	سعيد
سفارة	سفارة
سفر	سفر
سفن	سفينة
سفير	سفير
سفينة	سفينة
سقط	سقط
سقطت	سقط
سقف	سقف
سقوط	سقوط
سكان	ساكن
سكانها	ساكن
سكة	سكة
سكر	سكر
سكرتير	سكرتير
سكن	ساكن
سكنية	سكني
سكوت	سكوت
سلاح	سلاح
سلام	سلام
سلامة	سلامة
سلب	سلب
سلبا	سلب
سلبي	سلبي
سلبية	سلبي
سلة	سلة
سلسلة	سلسلة
سلطات	سلطة
سلطان	سلطان
سلطانك	سلطان
سلطة	سلطة
سلطنة	سلطنة
سلم	سلم
سلمت	سلم
سلمية	سلمي
سلوك	سلوك
سليط	سليط
سليم	سليم
سليمان	سليم
سليمة	سليم
سم	سم
سما	سم
سماء	سماء
سماحة	سماحة
سماع	سماع
سمح	سمح
سمحت	سمح
سمحتم	سمح
سمر	سمر
سمع	سمع
سمعة	سمعة
سمعت	سمع
سمعته	سمعة
سمعنا	سمع
سمك	سم
سمو	سمو
سموه	سم
سمية	سمية
سميت	سمى
سمير	سمير
سن	سن
سنة	سنة
سنتر	وتر
سنتين	سنة
سند	ودى
سنذهب	ذهب
سنغير	غير
سنفعل	فعل
سنقوم	قام
سنكون	كان
سنن	ونى
سنه	وهي
سنوات	سنة
سنوي	سنوي
سنويا	سنوي
سنوياً	سنوي
سنوية	سنوي
سنين	سنة
سهل	سهل
سهلا	سهل
سهلة	سهل
سهم	سهم
سهولة	سهولة
سو	سوى
سوء	سوء
سوا	أسى
سواء	سواء
سواحل	ساحل
سوداء	أسود
سور	سورة
سورة	سورة
سوري	سوري
سوريا	سوري
سورية	سوري
سوريتان	سوري
سوريين	سوري
سوف	سوف
سوفت	سوف
سوق	سوق
سوني	أسى
سوى	سوى
سوي	سوى
سويا	سوى
سوياً	سوي
سوية	سوي
سويت	سوى
سى	أسى
سي	سي
سيأتي	أتى
سيؤدي	أدى
سيئ	سيئ
سيئة	سيئ
سيا	سي
سياحة	سياح
سياحيا	سياحي
سياحية	سياحي
سيادة	سيادة
سيارات	سيارة
سيارة	سيارة
سيارتك	سيارة
سيارته	سيارة
سيارتها	سيارة
سيارتي	سيارة
سيارتين	سيارة
سياره	سيار
سياسات	سياسة
سياسة	سياسة
سياسي	سياسي
سياسيا	سياسي
سياسية	سياسي
سياسيون	سياسي
سياق	سياق
سيبقى	بقي
سيتم	تم
سيحدث	حدث
سيحصل	حصل
سيد	سيد
سيدات	سيد
سيدة	سيد
سيدتي	سيد
سيدنا	سيد
سيدني	أدنى
سيدى	ودى
سيدي	سيد
سير	رأى
سيرة	سيرة
سيرف	رف
سيصبح	صبح
سيطر	سيطر
سيطرة	سيطرة
سيطرت	سيطر
سيطرته	سيطرة
سيطرتها	سيطرة
سيعود	عاد
سيف	وفى
سيقوم	قام
سيكون	كان
سيلفي	ألفى
سيما	ما
سيناريو	سيناريو
سينجح	نجح
سينما	نام
سينمائي	سينمائي
شأن	شأن
شأنه	شأن
شأنها	شأن
شؤون	شأن
شئت	شاء
شئون	شأن
شاء	شاء
شائعات	شائعة
شائعة	شائعة
شاب	شاب
شابا	شاب
شابة	شاب
شابه	شاب
شابين	شاب
شاحنة	شاحنة
شادي	شادي
شارع	شارع
شارك	شارك
شاركت	شارك
شاركوا	شارك
شاشات	شاشة
شاشة	شاشة
شاطئ	شاطئ
شاعر	شاعر
شاغرة	شاغر
شاكر	شاكر
شال	شال
شامل	شامل
شاملة	شامل
شاهد	شاهد
شاهدت	شاهد
شاهدنا	شاهد
شاهين	شاهين
شباب	شاب
شبابي	شاب
شباك	شبكة
شبح	شبح
شبرا	شبر
شبكات	شبكة
شبكة	شبكة
شبكه	شبك
شبه	شبه
شبيه	شبيه
شتوية	شتوي
شتى	شتى
شجرة	شجرة
شحن	شحن
شخص	شخص
شخصا	شخص
شخصاً	شخص
شخصي	شخص
شخصيا	شخصي
شخصيات	شخصية
شخصياً	شخصي
شخصية	شخصي
شخصين	شخص
شخصيه	شخص
شد	شاد
شدة	شدة
شدد	شدد
شديد	شديد
شديدة	شديد
شر	شر
شراء	شراء
شرائح	شريحة
شراب	شراب
شراكة	شراكة
شرب	شرب
شربها	شرب
شرح	شرح
شرسة	شرس
شرط	شرط
شرطة	شرطي
شرطه	شرط
شرطي	شرطي
شرطيا	شرطي
شرطيين	شرطي
شرعي	شرعي
شرعية	شرعي
شرف	شرف
شرق	شرق
شرقي	شرق
شركاء	شريك
شركات	شركة
شركة	شركة
شركه	شرك
شرم	شرم
شروط	شرط
شروق	شروق
شريحة	شريحة
شريط	شريط
شريف	شريف
شريك	شر
شطب	شطب
شعار	شعار
شعارات	شعار
شعارك	شعار
شعب	شعب
شعبان	شعب
شعبة	شعبة
شعبنا	شعب
شعبه	شعب
شعبي	شعب
شعبية	شعبي
شعر	شعر
شعرت	شعر
شعرك	شعر
شعري	شعر
شعرية	شعري
شعوب	شعب
شعور	شعور
شغال	شغال
شغب	شغب
شغل	شغل
شفافة	شفاف
شفت	شف
شفيق	شفيق
شقة	شقة
شقق	شقة
شقيق	شقيق
شقيقتان	شقيق
شقيقه	شقيق
شقيقها	شقيق
شك	شك
شكر	شكر
شكرا	شكر
شكراً	شكر
شكري	شكر
شكل	شكل
شكلت	شكل
شكله	شكل
شكلها	شكل
شلل	شلتة
شم	شم
شمال	شمال
شمالا	شمال
شمالي	شمال
شمس	شمس
شمل	شمل
شملت	شمل
شموخ	شموخ
شمول	شمول
شن	شن
شنت	شن
شهاب	شهاب
شهادات	شهادة
شهادة	شهادة
شهد	شهد
شهداء	شهيد
شهدت	شهد
شهدتها	شهد
شهر	شهر
شهرا	شهر
شهرة	شهرة
شهري	شهر
شهريا	شهري
شهرية	شهري
شهرين	شهر
شهود	شاهد
شهور	شهر
شهيد	شهيد
شوارع	شارع
شواطئ	شاطئ
شوال	شوال
شوب	شوب
شوف	شوف
شوفوا	شوف
شوقي	شوق
شوكت	شوك
شون	شون
شوي	شوى
شوية	شوية
شيء	شيء
شيئا	شيئ
شيئاً	شيئ
شيخ	شيخ
شيعة	شيعي
شيك	شيك
شيوخ	شيخ
صابر	صابر
صاح	صاح
صاحب	صاحب
صاحبة	صاحب
صاحبه	صاحب
صاحبها	صاحب
صادر	صادر
صادق	صادق
صار	صار
صارت	صار
صارمة	صارم
صاروخ	صاروخ
صاعقة	صاعق
صافي	صافي
صالة	صالة
صالح	صالح
صالحة	صالح
صانع	صانع
صانعي	صانع
صباح	صباح
صباحا	صباح
صباحاً	صباح
صباحك	صباح
صبايا	صبي
صبحي	صبح
صبري	صبر
صح	صح
صحافة	صحافة
صحافي	صحافي
صحة	صحة
صحف	صحيفة
صحفي	صحيفة
صحفيا	صحفي
صحفية	صحفي
صحفيين	صحفي
صحي	صحي
صحية	صحي
صحيح	صحيح
صحيحاً	صحيح
صحيحة	صحيح
صحيفة	صحيفة
صخر	صخر
صدارة	صدارة
صدارته	صدارة
صدام	صدام
صدر	صدر
صدرت	صدر
صدري	صدر
صدفة	صدفة
صدق	صدق
صدقت	صدق
صدقني	صدق
صدقي	صدق
صدمة	صدمة
صدور	صدور
صدى	صدى
صديق	صديق
صديقة	صديق
صديقك	صديق
صديقه	صديق
صديقي	صديق
صراحة	صراحة
صراحه	صراح
صراع	صراع
صراف	صراف
صربيا	صربي
صرح	صرح
صرف	صرف
صريح	صريح
صعب	صعب
صعبا	صعب
صعبة	صعب
صعدة	صعدة
صعوبات	صعوبة
صعوبة	صعوبة
صعود	صعود
صعيد	صعيد
صغار	صغير
صغير	صغير
صغيرة	صغير
صف	صف
صفات	صفا
صفارات	صفارة
صفة	صفة
صفحات	صفحة
صفحة	صفحة
صفحته	صفحة
صفحتها	صفحة
صفحتي	صفحة
صفحه	صفح
صفر	أصفر
صفعة	صفعة
صفقات	صفقة
صفقة	صفقة
صفوف	صف
صفوفه	صف
صكوك	صك
صل	صلى
صلاة	صلاة
صلاح	صلاح
صلاحية	صلاحية
صلب	صلب
صلة	صلة
صلى	صلى
صلي	صلى
صمت	صمت
صمم	صمم
صممت	صمم
صمود	صمود
صناديق	صندوق
صناع	صانع
صناعة	صناعة
صناعية	صناعي
صندل	صندل
صندوق	صندوق
صنع	صنع
صنعت	صنع
صواريخ	صاروخ
صوب	صوب
صوت	صوت
صوتك	صوت
صوته	صوت
صوتي	صوت
صوتية	صوتي
صور	صورة
صورا	صورة
صورة	صورة
صورته	صورة
صوره	صورة
صورها	صورة
صيادو	صياد
صياغة	صياغة
صيام	صيام
صيانة	صيانة
صيد	صيد
صيغ	صيغة
صيغة	صيغة
صيف	صيف
صيني	صيني
صينية	صيني
ضابط	ضابط
ضاحية	ضاحية
ضباط	ضابط
ضبط	ضبط
ضحايا	ضحية
ضحك	ضحك
ضحية	ضحية
ضحيته	ضحية
ضخ	ضخ
ضخم	ضخم
ضخمة	ضخم
ضد	ضد
ضده	ضد
ضدهم	ضد
ضرائب	ضريبة
ضرب	ضرب
ضربات	ضربة
ضربة	ضربة
ضربت	ضرب
ضرر	ضرر
ضرورة	ضرورة
ضروري	ضروري
ضرورية	ضروري
ضريبة	ضريبة
ضع	وضع
ضعف	ضعف
ضعها	وضع
ضعيف	ضعيف
ضعيفة	ضعيف
ضغط	ضغط
ضغوط	ضغوط
ضم	ضم
ضمان	ضمان
ضمت	ضام
ضمن	ضام
ضمنها	ضمن
ضياع	ضيعة
ضيافة	ضيافة
ضيف	ضيف
ضيفا	ضيف
ضيفه	ضيف
ضيق	ضيق
طائرات	طائرة
طائرة	طائرة
طائفية	طائفي
طابع	طابع
طابور	طابور
طارئة	طارئ
طارق	طارق
طاقة	طاقة
طاقم	طاقم
طال	طال
طالب	طالب
طالبا	طالب
طالبات	طالب
طالبان	طالب
طالبة	طالب
طالبت	طالب
طاهر	طاهر
طاولة	طاولة
طب	طب
طباعة	طباعة
طبخ	طبخ
طبع	طبع
طبعا	طبع
طبعاً	طبع
طبق	طبق
طبقا	طبق
طبقة	طبقة
طبي	طب
طبيب	طبيب
طبيبنا	طبيب
طبية	طبي
طبيعة	طبيعة
طبيعي	طبيعي
طبيعية	طبيعي
طرائف	طريفة
طراز	طراز
طرح	طرح
طرحت	طرح
طرحه	طرح
طرحها	طرح
طرد	طرد
طرف	طرف
طرق	طريقة
طرقا	طريقة
طريق	طريق
طريقة	طريقة
طريقك	طريق
طريقه	طريق
طريقها	طريق
طريقي	طريق
طعام	طعام
طعم	طعم
طعن	طعن
طفرة	طفرة
طفل	طفل
طفلا	طفل
طفلة	طفل
طفلك	طفل
طفيف	طفيف
طقس	طقس
طلائع	طليعة
طلاب	طالب
طلب	طلب
طلبات	طلب
طلبة	طالب
طلبت	طلب
طلبك	طلب
طلبه	طلب
طلبي	طلب
طلعت	طلعت
طلقة	طلقة
طموح	طموح
طموحاتهن	طموح
طن	وطن
طوارئ	طوارئ
طوال	طويل
طور	طور
طول	طول
طوله	طول
طويل	طويل
طويلا	طويل
طويلاً	طويل
طويلة	طويل
طيار	طيار
طيب	طيب
طيبة	طيب
طيبه	طيب
طير	طير
طيران	طيران
طيف	طيف
طيلة	طيلة
طيور	طير
ظاهر	ظاهر
ظاهرة	ظاهر
ظبي	ظبي
ظروف	ظرف
ظريف	ظريف
ظل	ظل
ظلت	ظل
ظلم	ظلم
ظننت	ظن
ظهر	ظهر
ظهرت	ظهر
ظهور	ظهور
عائد	عائد
عائلات	عائلة
عائلة	عائلة
عائلته	عائلة
عائلتي	عائلة
عابد	عابد
عابر	عابر
عاجل	عاجل
عاجلا	عاجل
عاجلة	عاجل
عاد	عاد
عادة	عادة
عادت	عاد
عادل	عادل
عادى	عادى
عادي	عادي
عادية	عادي
عار	عاري
عارف	عارف
عازف	عازف
عاش	عاش
عاشت	عاش
عاشق	عاشق
عاشها	عاش
عاصفة	عاصفة
عاصفه	عاصف
عاصم	عاصم
عاصمة	عاصمة
عاطف	عاطف
عاطل	عاطل
عاطلين	عاطل
عافية	عافية
عافيه	عافي
عالقون	عالق
عالم	عالم
عالمنا	عالم
عالمي	عالم
عالميا	عالمي
عالمياً	عالمي
عالمية	عالمي
عالي	عالي
عالية	عالي
عام	عام
عاما	عام
عاماً	عام
عامة	عام
عامر	عامر
عامل	عامل
عاملا	عامل
عامه	عام
عامي	عام
عامين	عام
عباد	عباد
عبادة	عبادة
عبارات	عبارة
عبارة	عبارة
عبث	عبث
عبثه	عبث
عبد	عبد
عبدك	عبد
عبده	عبد
عبر	عبر
عبرت	عبر
عبرية	عبري
عبوة	عبوة
عبور	عبور
عبيد	عبد
عثر	عثر
عثرت	عثر
عجز	عجز
عجزت	عجز
عجلة	عجلة
عجوز	عجوز
عجيب	عجيب
عجيبة	عجيب
عد	عد
عدا	عد
عداد	عداد
عدة	عدة
عدت	عد
عدد	عدد
عددا	عدد
عدداً	عدد
عددها	عدد
عددهم	عدد
عدسة	عدسة
عدل	عدل
عدم	عدم
عدن	عاد
عده	عد
عدو	عدو
عدوان	عدو
عديدة	عديد
عذاب	عذاب
عذرا	عذر
عذراً	عذر
عراقي	عراقي
عراقية	عراقي
عرب	عربي
عربة	عربة
عربي	عربي
عربيا	عربي
عربية	عربي
عربيتي	عربي
عرش	عرش
عرشه	عرش
عرض	عرض
عرضا	عرض
عرضة	عرضة
عرضت	عرض
عرضه	عرض
عرضها	عرض
عرف	عرف
عرفت	عرف
عرقه	عرق
عروس	عروس
عروض	عرض
عز	عز
عزاء	عزاء
عزت	عز
عزف	عزف
عزل	عزل
عزلة	عزلة
عزيز	عزيز
عزيزتي	عزيز
عزيزي	عزيز
عساف	عساف
عسكري	عسكري
عسكريا	عسكري
عسكرية	عسكري
عسل	عسل
عسى	عسى
عسيري	عسير
عشاء	عشاء
عشائر	عشيرة
عشت	عاش
عشر	عشر
عشرات	عشر
عشرة	عشر
عشرون	عشر
عشرين	عشر
عشق	عشق
عشوائي	عشوائي
عشوائية	عشوائي
عشية	عشية
عصابات	عصابة
عصابة	عصابة
عصر	عصر
عصفور	عصفور
عصير	عصير
عضلات	عضلة
عضو	عضو
عضوا	عضو
عضوية	عضوية
عطاء	عطاء
عطر	عطر
عطل	عطل
عطلة	عطلة
عطية	عطية
عظيم	عظيم
عظيمة	عظيم
عفوا	عفو
عفواً	عفو
عفيفي	عفيف
عقار	عقار
عقارات	عقار
عقب	عقب
عقبة	عقبة
عقد	عقد
عقدة	عقدة
عقدت	عقد
عقده	عقد
عقل	عقل
عقلك	عقل
عقله	عقل
عقلي	عقل
عقوبات	عقوبة
عقوبة	عقوبة
عقود	عقد
عقول	عقل
عكاشة	عكاشة
عكس	عكس
علا	علا
علاج	علاج
علاقات	علاقة
علاقة	علاقة
علاقته	علاقة
علاقه	علاق
علام	علام
علامات	علامة
علامة	علامة
علاوة	علاوة
علبة	علبة
علق	علق
علم	علم
علما	علم
علماء	عالم
علماً	علم
علمت	علم
علمتني	علم
علمني	علم
علمه	علم
علمي	علم
علمية	علمي
علوم	علم
علوي	علو
على	على
علي	على
عليا	على
عليان	علي
علية	علي
عليك	على
عليكم	على
علينا	على
عليه	على
عليها	على
عليهم	على
عليهما	على
عم	عام
عما	عم
عماد	عماد
عمارة	عمارة
عمال	عامل
عمالة	عمالة
عمان	عم
عماني	عم
عمدة	عمدة
عمر	عمر
عمران	عمر
عمرك	عمر
عمره	عمر
عمرها	عمر
عمري	عمر
عمق	عمق
عمل	عمل
عملا	عمل
عملاء	عميل
عملائنا	عميل
عملاق	عملاق
عملاقة	عملاق
عملة	عملة
عملت	عمل
عملك	عمل
عملنا	عمل
عمله	عمل
عملها	عمل
عملهم	عمل
عملي	عمل
عمليات	عملية
عملية	عملية
عمليه	عمل
عموما	عم
عموماً	عم
عمومية	عمومي
عمي	عم
عميد	عميد
عميق	عميق
عميقة	عميق
عميل	عميل
عن	عن
عنا	عن
عناصر	عنصر
عناصرها	عنصر
عناوين	عنوان
عناية	عناية
عند	عند
عندك	عند
عندكم	عند
عندما	عندم
عندنا	عند
عنده	عند
عندها	عند
عندهم	عند
عندي	عند
عنصر	عنصر
عنصرية	عنصري
عنف	عنف
عنك	عن
عنكم	عن
عنه	عن
عنها	عن
عنهم	عن
عنوان	عنوان
عني	عن
عنيف	عنيف
عنيفة	عنيف
عهد	عهد
عهده	عهد
عواد	عواد
عوامل	عامل
عودة	عودة
عودته	عودة
عوده	عود
عوض	عوض
عون	عاون
عيادة	عيادة
عيال	عيال
عيان	عيان
عيب	عيب
عيد	عيد
عيش	عاش
عين	عين
عينات	عينة
عينة	عينة
عينت	عين
عينه	عين
عيني	عين
عينيك	عين
عينيه	عين
عيوب	عيب
عيون	عين
عيوني	عين
غاب	غاب
غادة	غادة
غادر	غادر
غادرت	غادر
غارات	غارة
غارة	غارة
غاز	غاز
غازي	غاز
غاضب	غاضب
غاضبة	غاضب
غال	غال
غالب	غالب
غالبا	غالب
غالباً	غالب
غالبية	غالبية
غالى	غالى
غالي	غال
غامضة	غامض
غانم	غانم
غاية	غاية
غبي	غبي
غد	غد
غدا	غد
غداً	غد
غذائية	غذائي
غراب	غراب
غرار	غرار
غرام	غرام
غرامة	غرامة
غرب	غرب
غربة	غربة
غربي	غرب
غربية	غربي
غرف	غرفة
غرفة	غرفة
غرق	غرق
غروب	غروب
غريب	غريب
غريبة	غريب
غريبه	غريب
غزالة	غزال
غزل	غزل
غزو	غزو
غزيرة	غزير
غسل	غسل
غش	غش
غضب	غضب
غضون	غضن
غطاء	غطاء
غلا	غلا
غلاف	غلاف
غلاك	غلا
غلط	غلط
غلق	غلق
غمار	غمار
غموض	غموض
غنى	غنى
غني	غني
غنية	غني
غياب	غياب
غيبوبة	غيبوبة
غيث	غيث
غير	غير
غيرت	غير
غيرك	غير
غيره	غير
غيرها	غير
غيرهم	غير
غيري	غير
ف	ف
فأنا	أن
فأنت	أن
فؤاد	فؤاد
فؤادي	فؤاد
فإننا	فإننا
فإنه	فإنه
فإنها	فإنها
فئات	فئة
فئة	فئة
فائدة	فائدة
فائق	فائق
فائقة	فائق
فات	فات
فاتن	فاتن
فاتورة	فاتورة
فاخر	فاخر
فادي	فادي
فارغ	فارغ
فارغة	فارغ
فارق	فارق
فاروق	فاروق
فاز	فاز
فازت	فاز
فاست	است
فاشل	فاشل
فاشلة	فاشل
فاضل	فاضل
فاضي	فاضي
فالنسيا	نسي
فان	فان
فانهم	فان
فاهم	فاهم
فبعد	عد
فتاة	فتاة
فتاوى	فتوى
فتح	حي
فتحة	فتحة
فتحت	فتح
فتحه	فتح
فتحي	حي
فترات	فترة
فترة	فترة
فتره	رأى
فتنة	فتنة
فتوضع	وضع
فتوى	فتوى
فتى	فتى
فتيات	فتاة
فجأة	فجأة
فجر	جار
فحسب	حسب
فحص	فحص
فخ	فخ
فخامة	فخامة
فخر	خر
فخري	خر
فدان	دان
فراغ	فراغ
فراق	راق
فرانك	ران
فرج	رج
فرح	فرح
فرحة	فرحة
فرد	رد
فردي	رد
فرسان	فرسان
فرش	رش
فرص	فرصة
فرصة	فرصة
فرصه	فرصة
فرض	رض
فرضت	رض
فرع	فرع
فرعه	فرع
فرعون	فرعون
فرعية	فرعي
فرق	فريق
فرقة	فرقة
فرنسي	فرنسي
فرنسية	فرنسي
فروحه	روح
فروع	فرع
فريد	راد
فريدة	فريد
فريق	فريق
فريقا	فريق
فريقه	فريق
فريقي	فريق
فزاعة	فزاعة
فساتين	فستان
فساد	ساد
فستان	فستان
فستاني	فستان
فسوف	سوف
فسيح	سيح
فشل	فشل
فشلا	فشل
فشلت	فشل
فصائل	فصيل
فصل	صلى
فض	فض
فضائية	فضائي
فضل	فضل
فضلا	فضل
فضلاً	فضل
فضلك	فضل
فضلكم	فضل
فضيحة	فضيحة
فضيلة	فضيلة
فعال	عال
فعالة	فعال
فعاليات	عالي
فعالية	عالي
فعل	فعل
فعلا	علا
فعلاً	فعل
فعلت	على
فعلته	على
فعلتها	على
فعله	فعل
فعلها	فعل
فعلى	على
فعندما	عندم
ففي	في
فقال	قال
فقالت	قال
فقد	قد
فقدان	قدا
فقدت	قد
فقراء	فقير
فقط	قط
فقلت	قال
فك	فك
فكان	كان
فكانت	كان
فكر	كر
فكرة	كرة
فكرت	كر
فكره	كر
فكري	كر
فكرية	فكري
فكل	كل
فكيف	كيف
فلا	فل
فلان	لان
فلتر	رأى
فلسطيني	فلسطيني
فلسطينيا	فلسطيني
فلسطينية	فلسطيني
فلسطينيين	فلسطيني
فلسفة	فلسفة
فلقد	قد
فلكية	فلكي
فلم	لم
فلما	ما
فلماذا	فلماذا
فلن	لان
فله	ل
فلوريدا	وريد
فلوس	فلس
فليس	ليس
فما	ما
فماذا	فماذا
فمن	من
فن	فن
فنادق	فندق
فنان	فنان
فنحن	حان
فندق	فندق
فنون	ونى
فني	فن
فنيا	فني
فنية	فني
فهد	هد
فهرس	فهرس
فهل	أهل
فهم	هم
فهمت	هم
فهمي	هم
فهناك	هن
فهو	فهو
فهي	فهي
فوائد	فائدة
فوجئت	فاجأ
فور	فور
فورا	فور
فوراً	فور
فورد	ورد
فوري	فور
فورية	فوري
فوز	فوز
فوزا	فوز
فوزان	وزان
فوزه	فوز
فوزي	فوز
فوق	فوق
فوكس	وكس
فولت	ولى
فون	ون
في	في
فيتامين	فيتامين
فيتنام	تنامى
فيجب	أجاب
فيديو	فيديو
فيرفض	رفض
فيروس	فيروس
فيسبوك	سب
فيصل	صلى
فيقول	قال
فيك	في
فيكم	في
فيل	ولى
فيلا	فيل
فيلم	لم
فيلما	لم
فيله	ولى
فيما	ما
فين	ونى
فينا	في
فيني	وني
فيه	في
فيها	في
فيهم	في
قائد	قائد
قائلا	قائل
قائلاً	قائل
قائلة	قائل
قائم	قائم
قائمة	قائمة
قابل	قابل
قابلة	قابل
قاتل	قاتل
قاد	قاد
قادة	قائد
قادر	قادر
قادرة	قادر
قادرين	قادر
قادم	قادم
قادما	قادم
قادمة	قادم
قارب	قارب
قاسم	قاسم
قاسياً	قاسي
قاسية	قاسي
قاضي	قاضي
قاعة	قاعة
قاعدة	قاعدة
قاعده	قاعد
قافلة	قافلة
قال	قال
قالب	قالب
قالت	قال
قاله	قال
قالها	قال
قالوا	قال
قام	قام
قامت	قام
قاموا	قام
قانون	قانون
قانوني	قانون
قانونية	قانوني
قبائل	قبيلة
قبالة	قبالة
قبر	قبر
قبضة	قبضة
قبل	قبل
قبلة	قبلة
قبله	قبل
قبلها	قبل
قبلي	قبل
قبلية	قبلي
قبول	قبول
قبيل	قبيل
قبيلة	قبيلة
قتال	قتال
قتل	قتل
قتلت	قتل
قتله	قتل
قتلوا	قتل
قتلى	قتيل
قتيل	قتيل
قتيلا	قتيل
قتيلاً	قتيل
قد	قد
قدامى	قديم
قدر	قدرة
قدرات	قدرة
قدرة	قدرة
قدرت	قدر
قدرتك	قدرة
قدرته	قدرة
قدرتها	قدرة
قدره	قدرة
قدرها	قدرة
قدم	قدم
قدما	قدم
قدمت	قدم
قدمه	قدم
قدمها	قدم
قدوم	قدوم
قدير	قدير
قديم	قديم
قديمة	قديم
قذائف	قذيفة
قرآن	قرآن
قرأ	قرأ
قرأت	قرأ
قراءة	قراءة
قرابة	قرابة
قرار	قرار
قرارا	قرار
قرارات	قرار
قراره	قرار
قراصنة	قرصان
قرب	قرب
قرر	قرر
قررت	قرر
قرص	قرص
قرض	قرض
قرعة	قرعة
قرن	قرن
قرى	قرية
قريب	قريب
قريبا	قريب
قريباً	قريب
قريبة	قريب
قرية	قرية
قسم	قسم
قصائد	قصيدة
قصة	قصة
قصتي	قصة
قصد	قصد
قصدك	قصد
قصدي	قصد
قصر	قصر
قصرت	قصر
قصص	قصة
قصف	قصف
قصفت	قصف
قصه	قص
قصور	قصر
قصي	قص
قصيدة	قصيدة
قصير	قصير
قصيرة	قصير
قضائي	قضائي
قضائيا	قضائي
قضائية	قضائي
قضاة	قاضي
قضايا	قضية
قضت	قضى
قضى	قضى
قضية	قضية
قط	قط
قطار	قطر
قطاع	قطاع
قطاعات	قطاع
قطب	قطب
قطر	قطر
قطع	قطع
قطعة	قطعة
قطعت	قطع
قف	وقف
قفل	قفل
قل	قال
قلب	قلب
قلبك	قلب
قلبه	قلب
قلبي	قلب
قلبية	قلبي
قلة	قلة
قلت	قال
قلته	قال
قلعة	قلعة
قلق	قلق
قلقة	قلق
قلم	قلم
قلنا	قال
قلوب	قلب
قلوبنا	قلب
قلوبهم	قلب
قليل	قليل
قليلا	قليل
قليلاً	قليل
قليلة	قليل
قم	قام
قمة	قمة
قمت	قام
قمح	قمح
قمر	قمر
قمصان	قميص
قمع	قمع
قمنا	قام
قمه	قم
قميص	قميص
قنا	قنا
قنابل	قنبلة
قناة	قناة
قناص	قناص
قناع	قناع
قناه	قنا
قنبلة	قنبلة
قنديل	قنديل
قنوات	قناة
قهر	قهر
قهوة	قهوة
قوائم	قائمة
قوات	قوة
قواته	قوة
قواتها	قوة
قواعد	قاعدة
قوالب	قالب
قوانين	قانون
قوة	قوة
قوته	قوة
قول	قول
قوله	قول
قولها	قول
قولي	قال
قوم	قوم
قومي	قام
قوه	وقى
قوى	قوة
قوي	قوى
قويا	قوى
قوية	قوي
قويه	قوى
قيادات	قيادة
قيادة	قيادة
قيادي	قيادي
قياس	قياس
قياسي	قياس
قياسية	قياسي
قيام	قيام
قيد	قاد
قيس	قيس
قيصر	قيصر
قيل	قال
قيم	قيم
قيمة	قيم
قيمته	قيم
قيمتها	قيم
قيود	قيد
كأس	أس
كأنك	كأنك
كأنه	كأنه
كأنها	كأنها
كابتن	كابتن
كاتب	كاتب
كاتبة	كاتب
كاتبها	كاتب
كاتم	كاتم
كاد	كاد
كارت	كارى
كارثة	كارثة
كاف	كافي
كافة	كافة
كافه	كاف
كافي	كافي
كافية	كافي
كافيه	كاف
كالتالي	تالي
كالعادة	عادة
كامل	كامل
كاملا	كامل
كاملاً	كامل
كاملة	كامل
كان	كان
كانا	كان
كانت	كان
كانوا	كان
كانون	كانون
كبار	كبير
كبرى	برى
كبريتية	كبريتي
كبير	كبير
كبيرا	كبير
كبيراً	كبير
كبيرة	كبير
كتائب	كتيبة
كتاب	كاتب
كتابا	كاتب
كتابة	كتابة
كتابه	كاتب
كتابي	كاتب
كتب	كتاب
كتبت	كتب
كتبه	كتاب
كتبها	كتاب
كتلة	كتلة
كتيبة	كتيبة
كثر	كثر
كثرة	ثر
كثير	كثير
كثيرا	كثير
كثيراً	كثير
كثيرة	كثير
كثيره	كثير
كثيرون	كثير
كدا	كد
كده	كد
كذا	ذو
كذاب	كذاب
كذب	كذب
كذبة	كذبة
كذلك	ذل
كراك	كر
كرامة	كرامة
كرة	كرة
كرت	كر
كرتون	كرتون
كرسي	كرسي
كرم	كرم
كره	كر
كرواتيا	كرواتي
كروز	روز
كروم	كرم
كريس	ريس
كريم	كريم
كريمة	كريم
كسب	سب
كسر	سر
كسرة	سرة
كشف	كشف
كشفت	كشف
كشك	شك
كغم	غم
كفاءة	كفاءة
كفاية	كفاية
كفر	فر
كفى	كفى
ككل	كل
كل	كل
كلا	كل
كلام	لام
كلامك	لام
كلامه	لام
كلامي	لام
كلانا	أكل
كلاهما	أكل
كلب	كلب
كلف	لف
كلفة	كلفة
كلفني	كلف
كلك	كل
كلكم	كل
كلم	لم
كلما	لم
كلمات	كلمة
كلماته	كلمة
كلمة	كلمة
كلمته	كلمة
كلمه	لم
كلنا	كل
كله	كل
كلها	كل
كلهم	كل
كلوم	كلم
كلي	كل
كليا	لي
كليات	كلية
كلياً	لي
كليب	كليب
كلية	كلي
كم	كم
كما	ما
كمال	مال
كمان	كمان
كمبيوتر	كمبيوتر
كميات	كمية
كمية	كمية
كمين	مين
كن	كان
كنا	كان
كنت	كان
كنتم	كان
كندا	ند
كنز	كنز
كنوز	كنز
كنيسة	كنيسة
كهرباء	كهرباء
كهربائي	كهربائي
كهربائية	كهربائي
كوافير	كوافير
كوبر	وبر
كوبري	وبر
كود	ود
كور	كور
كورة	كورة
كوريا	كارى
كوفي	وفي
كوكب	كوكب
كولومبيا	كولومبي
كوم	كوم
كوميديا	كوميدي
كون	كون
كونه	كون
كونها	كون
كوني	كان
كويتي	كويتي
كويس	كويس
كي	كي
كيا	كي
كيان	كيان
كيت	كيت
كيري	كير
كيس	كيس
كيف	كيف
كيفكم	كيف
كيفية	كيفية
كيفيه	كيفي
كيلو	كيلو
كيلومتر	كيلومتر
كيلومترا	كيلومتر
كيلومترات	كيلومتر
ل	ل
لآثار	أثر
لآخر	آخر
لأبناء	ابن
لأجل	أجل
لأجهزة	جهاز
لأحد	أحد
لأسباب	سبب
لأسرة	أسرة
لأسعار	سعر
لأصحاب	صاحب
لأعضاء	عضو
لأعلى	أعلى
لأفضل	أفضل
لأكبر	أكبر
لأكثر	أكثر
لألعاب	لعبة
لأمه	أم
لأن	أن
لأنك	أن
لأننا	أن
لأنني	أن
لأنه	أن
لأنها	أن
لأنهم	أن
لأهل	أهل
لأول	أول
لأي	أي
لإثبات	إثبات
لإحداث	إحداث
لإدارة	إدارة
لإزالة	إزالة
لإصدار	إصدار
لإصلاح	إصلاح
لإطلاق	إطلاق
لإعادة	إعادة
لإعداد	إعداد
لإعطاب	إعطاب
لإقامة	إقامة
لإنتاج	إنتاج
لإنشاء	إنشاء
لإنقاذ	إنقاذ
لإنقاص	إنقاص
لإيجاد	إيجاد
لا	لا
لائحة	لائحة
لاب	لاب
لاتحاد	اتحاد
لاتفاق	اتفاق
لاجئ	لاجئ
لاجئا	لاجئ
لاحظ	لاحظ
لاحظت	لاحظ
لاحق	لاحق
لاحقا	لاحق
لاحقاً	لاحق
لاحول	احول
لاختيار	اختيار
لادن	لادن
لازم	لازم
لاستخدام	استخدام
لاستضافة	استضافة
لاستعادة	استعادة
لاستقبال	استقبال
لاستكمال	استكمال
لاستلام	استلام
لاستمرار	استمرار
لاعب	لاعب
لاعبا	لاعب
لاعبو	لاعب
لاعبي	لاعب
لاعبين	لاعب
لاعبيه	لاعب
لافتا	لاف
لافتة	لافت
لامتحان	امتحان
لانتخابات	انتخاب
لاين	لاين
لبحث	بحث
لبدء	بدء
لبرنامج	برنامج
لبطولة	بطولة
لبعض	بعض
لبلاده	بلد
لبناء	بناء
لبنان	بنان
لبناني	بنى
لبنانية	لبناني
لبيب	لبيب
لبيع	بيع
لتأكيد	تأكيد
لتأمين	أم
لتبادل	تبادل
لتجنب	تجنب
لتحديد	تحديد
لتحررت	تحرر
لتحرير	تحرير
لتحسين	حس
لتحقيق	تحقيق
لتحميل	تحميل
لتحويل	تحويل
لتخفيف	تخفيف
لتدريب	تدريب
لترحيل	ترحيل
لتسجيل	تسجيل
لتسريع	تسريع
لتسهيل	تسهيل
لتشغيل	تشغيل
لتشكيل	تشكيل
لتصميم	تصميم
لتصنيع	تصنيع
لتصوير	تصوير
لتطبيق	تطبيق
لتطوير	تطوير
لتعديل	تعديل
لتعزيز	تعزيز
لتعلم	تعلم
لتعليم	تعليم
لتغطية	تغطية
لتغيير	تغيير
لتفادي	تفادي
لتفعيل	تفعيل
لتقديم	تقديم
لتقسيمها	تقسيم
لتقنية	تقنية
لتكون	وكى
لتكوني	تك
لتلك	تل
لتمديد	تمديد
لتمنعه	تمنع
لتمويل	تمويل
لتناول	تناول
لتنسيق	تنسيق
لتنظيف	تنظيف
لتنظيم	تنظيم
لتنفيذ	تنفيذ
لتنمية	تنمية
لتواصل	تواصل
لتوزيع	توزيع
لتوفير	توفير
لثلاثة	لثلاث
لثورة	ثورة
لجائزة	جائزة
لجامعة	جامعة
لجان	لجنة
لجديد	جديد
لجريدة	جريدة
لجعل	جعل
لجلال	جلال
لجلالة	جلالة
لجلب	جلب
لجلسة	جلسة
لجماعة	جماعة
لجمع	جمع
لجميع	جميع
لجنة	لجنة
لجنه	جن
لجهاز	جهاز
لحد	حد
لحركة	حركة
لحزب	حزب
لحساب	حساب
لحضور	حضور
لحظات	لحظة
لحظة	لحظة
لحفظ	حفظ
لحق	حق
لحقوق	حق
لحكم	حكم
لحكومة	حكومة
لحل	حل
لحم	لحم
لحماية	حماية
لحن	حان
لحوار	حوار
لحوم	لحم
لحين	حي
لخدمات	خدمة
لخدمة	خدمة
لخوض	خوض
لدخول	دخول
لدراسة	دراسة
لدرجة	درجة
لدعم	دعم
لدعوة	دعوة
لدفع	دفع
لدور	دار
لدورة	دورة
لدوري	دار
لدول	دولة
لدولة	دولة
لديك	ديك
لدينا	دين
لذا	ذو
لذة	لذة
لذلك	ذل
لذوي	ذو
لرؤية	رؤية
لرئاسة	رئاسة
لرئيس	رئيس
لرجل	رجل
لرعاية	رعاية
لرفع	رفع
لركن	ركن
لروسيا	روسي
لريال	ريال
لزعيم	زعيم
لزيادة	زيادة
لزيارة	زيارة
لسان	لسان
لسباق	سباق
لسباقات	سباق
لسبب	سبب
لست	ليس
لسماء	سماء
لسنا	ليس
لسنة	سنة
لسنوات	سنة
لسوء	سوء
لسوريا	سوري
لسورية	سوري
لشؤون	شأن
لشئون	شأن
لشباب	شاب
لشبكة	شبكة
لشخص	شخص
لشراء	شراء
لشركات	شركة
لشركة	شركة
لشهر	شهر
لص	لص
لصاحب	صاحب
لصاحبها	صاحب
لصالح	صالح
لصحيفة	صحيفة
لصفحة	صفحة
لصناعة	صناعة
لصنع	صنع
لصور	صورة
لضبط	ضبط
لضحايا	ضحية
لضرب	ضرب
لضم	ضم
لضمان	ضمان
لطائرات	طائرة
لطائرة	طائرة
لطرح	طرح
لطفي	لطف
لطلاب	طالب
لطلب	طلب
لطلبات	طلب
لطلبة	طالب
لطيران	طيران
لطيف	طيف
لطيفة	لطيفة
لعام	عام
لعب	لعبة
لعبة	لعبة
لعبت	لعب
لعبه	لعبة
لعدة	عدة
لعدد	عدد
لعدم	عدم
لعرض	عرض
لعقد	عقد
لعل	لعل
لعلاج	علاج
لعمال	عامل
لعمل	عمل
لعمليات	عملية
لعملية	عملية
لعنة	لعنة
لعودة	عودة
لعين	عين
لعيونكم	عين
لغات	لغة
لغاية	غاية
لغة	لغة
لغز	لغز
لغياب	غياب
لغير	غير
لفت	لاف
لفتح	فتح
لفترة	فترة
لفرض	فرض
لفروسية	فروسية
لفريق	فريق
لفك	لف
لفوز	فوز
لفيلم	فيلم
لقاء	لقاء
لقاءات	لقاء
لقائد	قائد
لقائه	لقاء
لقانون	قانون
لقب	لقب
لقبه	لقب
لقتل	قتل
لقد	قد
لقرار	قرار
لقسم	قسم
لقضية	قضية
لقطات	قط
لقطاع	قطاع
لقلة	قلة
لقمة	قمة
لقناة	قناة
لقوات	قوة
لقوانين	قانون
لقي	لقي
لقيادة	قيادة
لقيت	لقي
لك	ل
لكأس	كأس
لكافة	كافة
لكان	كان
لكرة	كرة
لكره	كر
لكسب	كسب
لكشف	كشف
لكل	كل
لكم	ل
لكن	كان
لكنك	كن
لكننا	كن
لكنني	كن
لكنه	كن
لكنها	كن
لكنهم	كن
لكني	كن
لكي	كي
لل	ل
للأبد	أبد
للأجيال	جيل
للأخبار	خبر
للأزمة	أزمة
للأسف	أسف
للأطفال	طفل
للأعضاء	عضو
للأفلام	فيلم
للأمام	أمام
للأمم	أمة
للأمن	أمن
للأندية	نادي
للأهلي	أهل
للإخوان	أخ
للإرهاب	إرهاب
للإسلام	إسلام
للإصابة	إصابة
للإصلاح	إصلاح
للإعلام	إعلام
للإعلان	إعلان
للإنسان	إنسان
للاتحاد	اتحاد
للاتصال	اتصال
للاتصالات	اتصال
للاجئي	لاجئ
للاجئين	لاجئ
للاحتفال	احتفال
للاحتفالات	احتفال
للاحتلال	احتلال
للاستثمار	استثمار
للاستضافة	استضافة
للاستفادة	استفادة
للاعبي	لاعب
للاعبين	لاعب
للاقتصاد	اقتصاد
للالتزام	التزام
للانتخابات	انتخاب
للانضمام	انضمام
للانقلاب	انقلاب
للبحث	بحث
للبحوث	بحث
للبرامج	برنامج
للبرلمان	برلمان
للبرميل	برميل
للبرنامج	برنامج
للبطالة	بطال
للبطولة	بطولة
للبلاد	بلد
للبنات	ابن
للبيت	بيت
للبيع	بيع
للتأكد	تأكد
للتبادل	تبادل
للتجارة	تجارة
للتحالف	تحالف
للتحقيق	تحقيق
للتحكم	تحكم
للتحميل	تحميل
للتخلص	تخلص
للتدخل	تدخل
للتدريب	تدريب
للتدوين	تدوين
للتسجيل	تسجيل
للتصميم	تصميم
للتظاهر	تظاهر
للتعامل	تعامل
للتعاون	تعاون
للتعبير	تعبير
للتعديل	تعديل
للتعرف	تعرف
للتعليم	تعليم
للتنس	تنس
للتنمية	تنمية
للتو	تو
للتواصل	تواصل
للثقافة	ثقافة
للثورة	ثورة
للجامعات	جامعة
للجامعة	جامعة
للجحيم	جحيم
للجدل	جدل
للجزء	جزء
للجزيرة	جزيرة
للجليل	جليل
للجمهور	جمهور
للجميع	جميع
للجنة	لجنة
للجهات	جهة
للجهاز	جهاز
للجوال	جوال
للجيش	جيش
للجيل	جيل
للحب	حب
للحد	حد
للحديث	حديث
للحرب	حرب
للحركة	حركة
للحزب	حزب
للحصول	حصول
للحظة	لحظة
للحفاظ	حفاظ
للحكم	حكم
للحكومة	حكومة
للحلول	حل
للحماية	حماية
للحوار	حوار
للحياة	حياة
للخارج	خارج
للخدمات	خدمة
للخروج	خروج
للخطر	خطر
للدخول	دخول
للدراجات	دراجة
للدراسات	دراسة
للدراسة	دراسة
للدعاية	دعاية
للدعم	دعم
للدفاع	دفاع
للدكتور	دكتور
للدور	دار
للدورة	دورة
للدوري	دار
للدول	دولة
للدولة	دولة
للذهاب	ذهاب
للرئاسة	رئاسة
للرئيس	رئيس
للربح	ربح
للرجال	رجل
للرد	رد
للرسول	رسول
للرفع	رفع
للزوار	زائر
للساحل	ساحل
للسعودية	سعودي
للسفارة	سفارة
للسلام	سلام
للسلطة	سلطة
للسلطنة	سلطنة
للسنة	سنة
للسياحة	سياح
للسيارات	سيارة
للسيدات	سيد
للسيطرة	سيطرة
للشؤون	شأن
للشاعر	شاعر
للشباب	شاب
للشراء	شراء
للشرطة	شرطي
للشرق	شرق
للشركات	شركة
للشركة	شركة
للشطرنج	شطرنج
للشعب	شعب
للشعر	شعر
للشيخ	شيخ
للصحافة	صحافة
للصحفيين	صحفي
للصناعات	صناعة
للصور	صورة
للطاقة	طاقة
للطفل	طفل
للطلاب	طالب
للطلب	طلب
للطيران	طيران
للعالم	عالم
للعام	عام
للعاملين	عامل
للعب	لعبة
للعبة	لعبة
للعديد	عديد
للعرب	عربي
للعرض	عرض
للعضو	عضو
للعلاج	علاج
للعلم	علم
للعلوم	علم
للعمال	عامل
للعمل	عمل
للعملاء	عميل
للعناية	عناية
للعهد	عهد
للعودة	عودة
للغاية	غاية
للغة	لغة
للغرب	غرب
للغربة	غربة
للفريق	فريق
للفلسطينيين	فلسطيني
للفنان	فنان
للفنون	فن
للفوز	فوز
للقاء	لقاء
للقانون	قانون
للقتال	قتال
للقرآن	قرآن
للقطاع	قطاع
للقوات	قوة
للقيام	قيام
للكاتب	كاتب
للكتاب	كاتب
للكتابة	كتابة
للكرة	كرة
للكشف	كشف
للمؤتمر	مؤتمر
للمبتدئين	مبتدئ
للمجتمع	مجتمع
للمجلس	مجلس
للمحافظة	محافظ
للمحترفين	محترف
للمحكمة	محكمة
للمخرج	مخرج
للمدونة	مدون
للمدينة	مدينة
للمرأة	مرأة
للمراسلة	مراسل
للمراسله	مراسل
للمرة	مرة
للمركز	مركز
للمزيد	مزيد
للمساعدة	مساعد
للمستشفى	مستشفى
للمستقبل	مستقبل
للمسرح	مسرح
للمسلمين	مسلم
للمشاركة	مشارك
للمشاهدة	مشاهد
للمصريين	مصري
للمطالبة	مطالب
للمعارضة	معارض
للمقاومة	مقاوم
للملك	ملك
للمملكة	مملكة
للمناطق	منطقة
للمنتخب	منتخب
للمنتدى	منتدى
للمنتديات	منتدى
للمنزل	منزل
للمنطقة	منطقة
للمواضيع	موضوع
للمواطنين	مواطن
للمواقع	موقع
للموسم	موسم
للموضوع	موضوع
للموقع	موقع
للمياه	ماء
للنادي	نادي
للناس	ناس
للناشئين	ناشئ
للنجاح	نجاح
للنساء	امرأة
للنسخ	نسخة
للنسخة	نسخة
للنسخه	نسخة
للنشر	نشر
للنظام	نظام
للنظر	نظر
للنفط	نفط
للنقاش	نقاش
للنوم	نوم
لله	ل
للهجوم	هجوم
للهواتف	هاتف
للوجبات	وجبة
للوحة	لوحة
للوصول	وصول
للوطن	وطن
للوقوف	وقوف
للولايات	ولاية
للي	ل
لليمن	يمن
لليوم	يوم
لم	لم
لمؤتمر	مؤتمر
لمؤسسة	مؤسس
لما	ما
لماذا	لماذا
لمباراة	مباراة
لمتابعة	متابع
لمتهم	ما
لمثل	مثل
لمجرد	مجرد
لمجلة	مجلة
لمجلس	مجلس
لمجموعة	مجموعة
لمحاربة	محارب
لمحافظة	محافظ
لمحركات	محرك
لمدة	مدة
لمده	مد
لمدينة	مدينة
لمراسلتي	مراسل
لمراقبة	مراقب
لمرضى	مريض
لمركز	مركز
لمرورك	مرور
لمزيد	مزيد
لمسابقة	مسابقة
لمسات	لمسة
لمساعدة	مساعد
لمسة	لمسة
لمستخدمي	مستخدم
لمشاهدة	مشاهد
لمشاهدتها	مشاهد
لمشروع	مشروع
لمشكلة	مشكلة
لمصر	مصر
لمصلحة	مصلحة
لمعالجة	معالجة
لمعرفة	معرفة
لمكافحة	مكافحة
لمن	من
لمناقشة	مناقشة
لمنتجات	منتج
لمنتخب	منتخب
لمنتداك	منتدى
لمنتدى	منتدى
لمنتديات	منتدى
لمنطقة	منطقة
لمنظمة	منظم
لمنع	منع
لمهرجان	مهرجان
لمواجهة	مواجهة
لمواصلة	مواصلة
لمواضيع	موضوع
لمواقع	موقع
لموقع	موقع
لموقعك	موقع
لموقعي	موقع
لمياه	ماء
لن	لان
لنا	ل
لنادي	نادي
لنازحي	نازح
لندن	ند
لنسخ	نسخة
لنسخة	نسخة
لنشر	نشر
لنظام	نظام
لنفس	نفس
لنفسك	نفس
لنفسه	نفس
لنقل	نقل
لنهائي	نهائي
لنيل	نيل
له	ل
لها	ل
لهجوم	هجوم
لهم	ل
لهما	ل
لهيئة	هيئة
لو	لو
لواء	لواء
لوجه	وجه
لوجود	وجود
لوحات	لوحة
لوحة	لوحة
لوحده	وحد
لوحه	لوح
لوزارة	وزارة
لوزير	وزير
لوضع	وضع
لوقت	وقت
لوقف	وقف
لوك	ولى
لوكالة	وكالة
لولا	لولا
لولاية	ولاية
لولي	ولى
لون	ون
لونه	ون
لى	ولى
لي	ل
ليا	لي
ليالي	ليلة
ليالينا	ليلة
ليبرمان	برم
ليبي	ليبي
ليبيا	ليبي
ليبية	ليبي
ليتم	يتم
ليس	ليس
ليست	ليس
ليسوا	ليس
ليك	ولى
ليكون	وكى
ليل	ليل
ليلا	ليل
ليلة	ليلة
ليلي	ليل
ليلية	ليلي
لين	لاين
لينك	لاين
ليه	ولى
ليوم	يوم
مأدبة	مأدبة
مأرب	مأرب
مأزق	مأزق
مأساة	مأساة
مؤامرة	مؤامرة
مؤتمر	مؤتمر
مؤتمرا	مؤتمر
مؤثر	مؤثر
مؤثرة	مؤثر
مؤخرا	مؤخر
مؤخراً	مؤخر
مؤسس	مؤسس
مؤسسات	مؤسس
مؤسسة	مؤسس
مؤشر	مؤشر
مؤشرات	مؤشر
مؤقت	مؤقت
مؤقتا	مؤقت
مؤقتة	مؤقت
مؤكدا	مؤكد
مؤكداً	مؤكد
مؤكدة	مؤكد
مؤلف	مؤلف
مؤمن	مؤمن
مئات	مائة
مئة	مائة
مئوية	مئوي
ما	ما
ماء	ماء
مائة	مائة
مات	ما
ماتت	مات
مادة	مادة
مادونا	ماد
مادي	ماد
ماذا	ماذا
ماراثون	ماراثون
مارس	مارس
مارك	مار
ماريا	مارى
ماسة	ماسة
ماضي	ماضي
ماضيين	ماضي
ماك	ما
ماكس	ماكس
مال	مال
مالا	مال
مالك	مال
ماله	مال
مالي	مال
مالية	مالي
ماليزيا	ماليزي
مان	ما
مانع	مانع
ماني	ما
ماهر	ماهر
ماي	ما
مباحث	مبحث
مبادئ	مبدأ
مبادرة	مبادرة
مباراة	مباراة
مباراته	مباراة
مباراتين	مباراة
مبارك	مبارك
مباشر	مباشر
مباشرة	مباشر
مباشره	مبشرة
مبالغ	مبلغ
مبدأ	مبدأ
مبدع	مبدع
مبرر	مبرر
مبرمج	مبرمج
مبروك	مبروك
مبعوث	مبعوث
مبعوثا	مبعوث
مبكر	مبكر
مبكرا	مبكر
مبكرة	مبكر
مبلغ	مبلغ
مبنى	مبنى
مبني	مبني
مبوبة	مبوب
مبيعات	مبيعات
مبينا	مبين
مت	ما
متأخر	متأخر
متأخرة	متأخر
متأكد	متأكد
متأكدة	متأكد
متألق	متألق
متابع	متابع
متابعات	متابع
متابعة	متابع
متاح	متاح
متاحة	متاح
متاحف	متحف
متتالية	متتالي
متجدد	متجدد
متجددة	متجدد
متجر	متجر
متحدث	متحدث
متحرك	متحرك
متحركة	متحرك
متحف	متحف
متخصص	متخصص
متخصصة	متخصص
متر	متر
مترا	متر
مترجم	مترجم
مترو	مترو
متزوجات	متزوج
متصرفا	متصرف
متصل	متصل
متطورة	متطور
متعب	متعب
متعة	متعة
متعدد	متعدد
متعددة	متعدد
متعلقات	متعلق
متعلقة	متعلق
متفجرة	متفجر
متفرقة	متفرق
متقدم	متقدم
متقدمة	متقدم
متكامل	متكامل
متكاملة	متكامل
متلازمة	متلازمة
متمكن	متمكن
متميز	متميز
متميزة	متميز
متن	مات
متنقلا	متنقل
متنقلة	متنقل
متنها	متن
متنوعة	متنوع
متهم	ما
متهما	ما
متهمين	متهم
متواجد	متواجد
متواصل	متواصل
متواصلة	متواصل
متوافق	متوافق
متوسط	متوسط
متوسطة	متوسط
متوفر	متوفر
متوفرة	متوفر
متوقع	متوقع
متوقعة	متوقع
متوقف	متوقف
متوقفة	متوقف
متى	متى
مثال	مثال
مثالي	مثال
مثالية	مثالي
مثبت	مثبت
مثل	مثل
مثلا	مثل
مثلاً	مثل
مثلك	مثل
مثله	مثل
مثلها	مثل
مثلي	مثل
مثير	مثير
مثيرة	مثير
مثيل	مثيل
مج	مج
مجازر	مجزرة
مجال	مجال
مجالات	مجال
مجالاته	مجال
مجالس	مجلس
مجانا	مجان
مجاناً	مجان
مجاني	مجان
مجانية	مجاني
مجانيه	مجان
مجاهد	مجاهد
مجاورة	مجاور
مجتمع	مجتمع
مجتهد	مجتهد
مجد	مجد
مجددا	مجدد
مجدداً	مجدد
مجدي	مجد
مجرب	مجرب
مجرد	مجرد
مجرم	مجرم
مجرى	مجرى
مجزرة	مجزرة
مجلة	مجلة
مجلد	مجلد
مجلس	مجلس
مجمع	مجمع
مجمل	مجمل
مجموع	مجموع
مجموعات	مجموعة
مجموعة	مجموعة
مجموعه	مجموع
مجند	مجند
مجنون	مجنون
مجهر	مجهر
مجهود	مجهود
مجهول	مجهول
مجهولة	مجهول
مجهولون	مجهول
مجهولين	مجهول
محادثات	محادثة
محادثة	محادثة
محاربة	محارب
محاسبة	محاسب
محاصيل	محصول
محاضرات	محاضرة
محاضرة	محاضرة
محافظ	محافظ
محافظات	محافظ
محافظة	محافظ
محاكم	محكمة
محاكمة	محاكمة
محامو	محامي
محامون	محامي
محامي	محامي
محاور	محور
محاولات	محاولة
محاولة	محاولة
محاولتين	محاولة
محب	محب
محتاج	محتاج
محترف	محترف
محترفين	محترف
محتمل	محتمل
محتملة	محتمل
محتوى	محتوى
محتويات	محتوى
محجبات	محجبة
محجوب	محجوب
محدد	محدد
محددة	محدد
محدود	محدود
محدودة	محدود
محرر	محرر
محرك	محرك
محركات	محرك
محرم	محرم
محروس	محروس
محسن	محسن
محضر	محضر
محطات	محطة
محطة	محطة
محفوظ	محفوظ
محفوظة	محفوظ
محق	محق
محقة	محق
محكمة	محكمة
محل	محل
محلات	محل
محلب	محلب
محللون	محلل
محلي	محلي
محليا	محلي
محليات	محلي
محلية	محلي
محملة	محمل
محمود	محمود
محمول	محمول
محمولة	محمول
محمية	محمي
محو	محو
محور	محور
محول	محول
محيط	محيط
مخازن	مخزن
مخاطر	مخاطر
مخالف	مخالف
مخالفات	مخالف
مخالفة	مخالف
مخاوف	مخاوف
مختار	مختار
مختارة	مختار
مخترع	مخترع
مخترق	مخترق
مختصر	مختصر
مختلف	مختلف
مختلفة	مختلف
مختلفون	مختلف
مخدر	مخدر
مخدرات	مخدر
مخرج	مخرج
مخزن	مخزن
مخزون	مخزون
مخصص	مخصص
مخصصة	مخصص
مخطط	مخطط
مخططات	مخطط
مخيم	مخيم
مد	مد
مدار	مدار
مدارس	مدرسة
مدافع	مدفع
مداهمات	مداهمة
مدة	مدة
مدحت	مدح
مدخل	مدخل
مدرب	مدرب
مدربا	مدرب
مدربات	مدرب
مدربه	مدرب
مدرج	مدرج
مدرس	مدرس
مدرسة	مدرسة
مدرعتين	مدرعة
مدري	مدر
مدعومة	مدعوم
مدفوع	مدفوع
مدمر	مدمر
مدمن	مدمن
مدن	مدينة
مدني	مدينة
مدنية	مدني
مدنيين	مدني
مدونات	مدون
مدونة	مدون
مدونتك	مدون
مدونتي	مدون
مدونه	مدون
مدى	مدية
مدي	مد
مدير	مدير
مديرا	مدير
مديرة	مدير
مديريات	مديرية
مديرية	مديرية
مدينة	مدينة
مدينتي	مدينة
مدينه	مدين
مذابح	مذبحة
مذبحة	مذبحة
مذكرات	مذكر
مذكرة	مذكر
مذهل	مذهل
مذهلة	مذهل
مذيع	مذيع
مذيعة	مذيع
مر	مر
مرأة	مرأة
مرات	مرة
مراجعات	مراجع
